################################
                    ##  ##    ##
##  ####  ##  ######        ####
##    ##    ##        ##  ##  ##
##  ######      ##  ####      ##
##    ##  ####    ##    ####  ##
####  ##      ####    ##  ##  ##
####    ####        ##    ##  ##
##  ##      ##  ##      ##    ##
##  ######  ##    ##  ##    ####
##      ##      ####  ##  ##  ##
####  ##  ####  ##    ##      ##
##    ##      ##    ########  ##
####  ##  ##      ##  ##      ##
##          ##  ##        ##    
################################
