################################
      ##  ##      ####        ##
####          ##      ##  ######
##    ########    ##  ##      ##
##  ##        ##  ##  ##  ##  ##
##  ####  ##    ##  ##  ####  ##
##    ##    ##  ##            ##
####    ##  ##    ##  ##  ##  ##
######  ##    ##  ####    ##  ##
######  ##  ##          ##    ##
####    ##  ##  ######    ##  ##
##    ##      ##    ####    ####
####  ##  ##    ##      ##    ##
##      ##    ##    ##  ####  ##
##  ##      ##    ##            
################################
