################################
    ##      ##      ####  ##  ##
##      ##      ##            ##
##  ####  ####    ##  ##  ##  ##
##    ##  ##  ##    ##  ##    ##
####  ##        ##  ##      ####
##      ####  ####    ##  ######
##  ##    ##      ##  ##    ####
##  ####      ##  ##  ####    ##
##    ######  ##  ##      ######
##  ##      ##    ######      ##
####    ##    ##        ####  ##
####  ######  ##########      ##
##      ##  ##          ####  ##
##  ##          ##  ##          
################################
