################################
                ##      ####  ##
####  ##  ####  ##  ##        ##
##    ##      ####    ####  ####
##  ##  ####  ##  ##    ##    ##
####      ##          ##    ####
##    ##    ######  ####  ##  ##
####    ##        ##          ##
##  ##    ##  ##  ##  ####  ####
##    ##  ####        ####    ##
##  ####      ####  ##      ####
##  ##    ##      ##  ##  ##  ##
##  ##  ##  ####  ##      ##  ##
##  ##  ##    ##  ##  ######  ##
##          ##    ##            
################################
