################################
    ######      ##      ##  ####
##    ##    ##      ##  ##    ##
####    ##  ##  ####      ##  ##
##  ##  ##  ##  ######  ##    ##
##  ##  ##  ##    ##      ##  ##
##  ##        ##  ##  ##      ##
##  ##  ########    ##  ####  ##
##  ####        ##  ##        ##
##        ####  ##    ##########
####  ##  ##      ##          ##
##  ##  ##    ##    ########  ##
##        ####    ##      ##  ##
##  ####        ####  ##  ##  ##
##      ##  ##        ##        
################################
