################################
            ##      ####    ####
##  ##  ##      ##      ##    ##
##  ##    ######  ####    ##  ##
##  ##  ##    ##  ##    ##    ##
##    ##    ##    ##  ##  ##  ##
####  ##  ##    ####          ##
##    ##      ##    ####  ##  ##
##  ##  ##  ######  ##  ##    ##
##  ##        ####        ##  ##
##  ####  ##        ####  ##  ##
##      ##    ##  ##          ##
##  ##    ######  ########  ####
##  ####        ##        ##  ##
##      ##  ##      ####        
################################
