################################
              ##  ##        ####
##  ##  ####  ##  ##  ####    ##
##  ##    ##  ##  ##  ######  ##
##    ##  ##  ##  ##    ##    ##
####  ##  ##  ##    ##  ##  ####
##  ##    ##    ##  ##  ##    ##
##      ##  ##  ##  ##    ##  ##
##  ##  ##  ##      ######    ##
##    ##      ######      ##  ##
##  ##    ##          ##      ##
##      ##  ####################
##  ####              ##      ##
##    ####  ########  ####  ####
####        ##                  
################################
