################################
                    ##      ####
##  ####  ########  ##  ##    ##
##    ##          ##    ####  ##
####    ##  ####      ##      ##
####  ##  ##    ######    ##  ##
##    ##      ##      ##  ######
####      ##  ##  ##  ##      ##
##  ####    ##  ####    ####  ##
##      ##          ##    ##  ##
####  ##  ######  ##    ##    ##
##            ##  ##  ##    ####
####  ##  ######  ##    ##    ##
##      ##          ##  ####  ##
##  ##      ##  ##  ##          
################################
