################################
          ##      ##  ######  ##
##  ##  ##    ##  ##    ##    ##
##  ##      ##    ####      ####
####    ####  ##        ##    ##
##    ##        ########  ##  ##
####    ##  ##  ##            ##
##    ##  ####  ########  ##  ##
####      ##            ##    ##
##    ##    ##########  ##  ####
##  ##  ##          ##  ##  ####
##  ##    ######  ##    ##    ##
##  ####      ##    ##  ####  ##
##        ##    ##  ##    ##  ##
####  ##    ##  ##      ##      
################################
