################################
        ##      ##      ##    ##
##  ##      ##  ##  ##      ####
##    ######    ##    ####    ##
####  ##      ######  ##  ##  ##
####    ####    ##        ##  ##
##  ##  ##  ##  ##  ######    ##
##  ##  ##  ##    ##      ##  ##
##  ##  ##  ##  ##    ##      ##
##  ##  ##  ##    ##  ######  ##
##  ##  ##      ##        ######
##  ##  ##  ##    ##  ##      ##
##    ##  ##  ##    ##    ##  ##
##  ####        ##  ########  ##
##        ####                  
################################
