################################
        ####      ##          ##
####  ##      ##    ##  ####  ##
##        ####  ####      ##  ##
####  ####  ##      ######    ##
##      ##      ##      ##  ####
##  ##  ##  ##    ####      ####
####    ##  ##  ##    ####    ##
##    ##    ####    ##    ##  ##
##  ####  ##      ##    ####  ##
##  ##    ####  ##    ##      ##
##      ##      ####      ######
########    ##        ####    ##
##    ##  ##  ##########  ##  ##
####                            
################################
