################################
          ##                  ##
####  ##      ##########  ##  ##
##    ##  ##  ##        ##    ##
####    ##    ##  ####  ##  ####
##  ##  ##  ##      ##  ##    ##
##      ##    ####  ##    ##  ##
##  ####    ##      ####    ####
####      ##    ####    ##    ##
####  ##    ##  ##    ##    ####
##    ######    ####  ##  ##  ##
##  ##      ####      ##  ##  ##
##  ##  ##        ####    ##  ##
##        ######      ##  ##  ##
##  ####        ####            
################################
