################################
                  ####        ##
######  ##  ######      ##  ####
##      ####        ######    ##
##  ##    ##  ########    ##  ##
##  ######    ##        ##    ##
##      ##  ##  ##  ####    ####
##  ##      ##          ##    ##
##    ######  ########    ##  ##
####  ##            ##  ##    ##
##    ##  ##  ####  ##  ##  ####
####    ##      ##      ##    ##
##  ##      ####    ##  ####  ##
##    ######      ##  ##      ##
####          ##  ##      ##    
################################
