################################
            ##  ##      ##    ##
##  ####  ##      ##  ##  ##  ##
##  ####      ##  ##  ##      ##
##      ##  ####  ##    ##  ####
####  ##    ##      ##  ##    ##
##  ##    ####  ##      ####  ##
##  ##  ##      ########      ##
##      ##  ####          ######
##  ##  ##    ##  ##  ####    ##
##  ####    ##      ##      ####
##      ##    ####  ##  ##    ##
##  ##    ##    ##  ##  ##  ####
##  ####    ######  ##  ##    ##
##      ##                ##    
################################
