################################
                        ##    ##
##  ####  ############  ####  ##
##  ##  ##          ##    ##  ##
##  ##      ##  ##  ##  ##    ##
##    ##  ##    ######      ####
####  ##  ####        ####    ##
##    ##      ##  ##      ##  ##
##  ##  ######      ####      ##
##            ####      ####  ##
##  ####  ##      ######    ####
##  ##  ##  ####        ##  ####
##          ##  ####  ####    ##
##########  ##    ##      ##  ##
##              ##    ##        
################################
