################################
      ####                    ##
##  ##      ############  ######
##  ##  ####          ##  ##  ##
##      ##  ####  ##  ##      ##
##  ####          ##    ########
##    ######  ####  ##  ##    ##
####          ##    ##  ##  ####
##############    ####      ####
####        ##  ####  ####    ##
##    ####                ##  ##
##  ##    ##  ##  ##########  ##
##  ##  ##  ##    ##          ##
##  ##      ##  ##    ##  ######
##      ##  ##      ##          
################################
