################################
          ##            ##    ##
##  ####    ##########      ####
##  ##  ##          ####  ######
##  ##    ##  ######        ####
##  ####    ##      ######    ##
##      ##      ##        ##  ##
####  ##    ####    ####      ##
####    ####      ####  ##  ####
##  ##      ##  ####    ##    ##
##    ####  ##        ##    ####
##  ##      ##  ##  ##    ##  ##
##  ##  ##  ##    ##    ####  ##
##    ##      ##  ##  ##      ##
####      ##      ##      ##    
################################
