################################
            ##                ##
##  ##  ####    ####  ######  ##
##  ##  ##    ##      ##      ##
####    ##  ##    ####    ##  ##
####  ####    ##  ##    ####  ##
##    ##  ##  ##  ######      ##
##  ##        ##        ##  ####
##      ####    ######    ##  ##
##  ####    ####      ##      ##
##  ##  ##        ##    ##  ####
##  ##      ##  ##  ##  ##  ####
##    ######    ##      ####  ##
##  ##      ##    ##  ##      ##
##      ##      ##        ##    
################################
