################################
          ##        ##        ##
##  ####    ##  ##  ##  ##  ####
##      ##      ##    ####    ##
##  ##  ####  ##  ##        ####
##  ##      ##    ########  ####
##  ######    ##              ##
####        ####  ##  ######  ##
##    ######      ####      ####
####        ##  ##  ##  ##    ##
##    ####    ####        ##  ##
##  ####  ##      ########    ##
##  ##    ##  ##  ##        ####
##  ##  ##    ####    ##  ##  ##
##        ##        ##          
################################
