################################
                    ##        ##
##  ##  ####  ####    ####  ####
##  ##    ####      ##      ####
##  ####      ####      ##    ##
##    ######  ##  ######  ##  ##
####      ##  ##              ##
##    ##  ##    ##  ##  ########
##  ####  ####    ##          ##
##  ##        ##    ########  ##
####    ####    ##  ##      ####
##    ####  ####        ##    ##
##  ##          ############  ##
######  ######  ##      ####  ##
##      ##          ##          
################################
