################################
        ##                    ##
####  ##    ####  ##  ##########
##    ##  ##  ##  ####        ##
##  ##    ##  ##        ####  ##
##  ##  ##      ########    ####
##  ##  ##  ##            ##  ##
##  ##      ##  ##  ####      ##
##    ######  ######    ####  ##
####      ##    ##    ##      ##
##    ##    ##      ##  ##  ####
##  ##  ##      ######  ##  ####
##      ##  ##          ##    ##
##  ##    ##  ######  ####  ####
##    ##          ##            
################################
