################################
    ##        ##      ######  ##
##    ##  ####    ##    ##    ##
####          ##    ##      ####
##    ######    ##  ##  ##  ####
##  ##      ##  ##  ##  ##    ##
##    ####  ##  ##  ##    ##  ##
####        ##    ##    ####  ##
##  ######    ####  ##  ##    ##
##  ##      ##      ##    ##  ##
##      ####    ##  ####    ####
##  ####      ####      ##    ##
##  ##    ####    ##  ##  ##  ##
##      ##      ####  ##  ##  ##
####  ##    ##                  
################################
