################################
    ##  ##  ##        ##      ##
##            ##  ##  ######  ##
##  ####  ##  ##  ##          ##
##    ##  ##      ##  ####  ####
####  ##  ####  ##  ##        ##
##    ##      ##      ##  ##  ##
##  ##  ##  ####  ##  ##  ##  ##
##  ##          ##      ##    ##
######  ##  ####  ####    ##  ##
##        ##          ##    ####
##  ####  ##  ##  ##    ##    ##
##  ####  ##    ##  ##    ##  ##
##      ####  ##    ##  ####  ##
##  ##            ##            
################################
