################################
    ##    ##                  ##
##    ##  ##  ####  ####  ##  ##
####      ##  ##  ##  ##  ######
##    ##  ##  ##      ##      ##
##  ##            ##    ####  ##
##  ####  ####  ##    ##      ##
####    ##  ##  ##  ##    ##  ##
####  ##      ##      ##  ##  ##
##    ##  ##      ##  ##  ##  ##
##  ##  ##  ######  ##      ####
##  ##                ####  ####
##  ##  ########  ##    ##    ##
##  ##  ##    ##  ####    ##  ##
##        ##          ##        
################################
