################################
    ##        ##        ##    ##
##  ##  ####  ##  ##  ##    ####
##      ##    ##  ##    ##    ##
########    ##      ##    ##  ##
##        ##    ######  ####  ##
##  ######    ####      ##    ##
##  ##      ##      ####    ####
##  ##  ####    ####      ##  ##
##  ##  ##    ##      ######  ##
##  ##    ##      ####        ##
##    ##    ######      ####  ##
####  ####  ##      ####      ##
##      ##  ##  ######    ##  ##
##  ##          ##      ##      
################################
