################################
      ##    ######            ##
####    ##    ##    ########  ##
##  ##    ##      ##      ##  ##
##  ####      ####    ##      ##
##        ##  ##    ##  ####  ##
##########    ##  ##          ##
##        ####    ##  ##  ######
##  ########    ##    ##  ##  ##
##            ##  ##    ##    ##
##  ##  ######    ####  ##  ####
####  ##      ##        ##    ##
##        ####    ######    ####
##  ######  ##  ####      ##  ##
##                    ##        
################################
