################################
            ##            ##  ##
##  ##  ##    ##  ##  ####    ##
##    ##  ##  ##  ##        ####
####  ##  ##  ##    ##  ##    ##
##    ##  ##    ##    ##    ####
####  ##    ##    ##  ##  ##  ##
####    ##    ##  ##  ##      ##
##  ##    ##  ##  ##    ####  ##
##  ##  ####  ##    ##  ####  ##
##  ##        ##  ##        ####
##    ##########    ######    ##
##  ####          ##      ##  ##
##  ##    ##  ######  ##  ##  ##
##      ##            ##        
################################
