################################
        ####      ##  ##      ##
##  ##        ##  ##      ##  ##
##  ######  ##        ####    ##
##      ##    ##########    ####
##  ##  ##  ##          ####  ##
##  ##    ##    ######        ##
##  ####    ##        ##  ##  ##
##      ##    ####  ######    ##
####  ####  ##    ##  ##    ####
##  ##          ####  ##  ######
##      ##  ##        ##    ####
####  ##    ########  ####    ##
##    ######        ##      ####
####          ####      ##      
################################
