################################
    ##        ####    ####    ##
##  ##  ####        ##      ####
##          ##  ##  ##  ##    ##
##  ########    ####    ####  ##
####      ##  ##      ##  ##  ##
##    ##  ##  ##  ####    ##  ##
##  ####      ##    ####      ##
##  ##    ####  ##      ##  ####
##  ##  ##        ####  ##    ##
##    ####  ####    ##  ####  ##
####        ##  ##  ####      ##
##    ####  ##  ##    ##  ##  ##
####  ##  ##      ##        ####
##            ##    ##  ##      
################################
