################################
                      ####    ##
##########  ##  ####        ####
##        ####      ##  ##  ####
##  ####      ####    ##      ##
##    ######    ##  ##    ##  ##
####        ##      ##  ##  ####
####  ####    ####    ##      ##
##    ##  ##  ##    ##    ##  ##
##  ##    ##    ####    ##    ##
##    ##    ##        ##    ####
####    ##    ##  ####    ##  ##
##  ##  ##  ##  ##    ####    ##
##  ##  ##        ##      ##  ##
##          ####      ##        
################################
