################################
          ##  ##    ##      ####
##  ####          ##    ##    ##
##  ##    ##  ##  ##  ##  ##  ##
####    ##      ##    ##      ##
##    ##    ##  ##  ##    ######
##  ##  ########    ##  ##    ##
##  ##      ##    ##    ##  ####
##  ##  ##    ##  ##  ##      ##
##        ##  ##  ##    ####  ##
##  ##  ##    ##  ######      ##
##    ##    ####      ##  ##  ##
####  ##  ##    ####  ##  ##  ##
##    ##  ##  ####      ####  ##
##  ##              ##          
################################
