################################
                ##  ##      ####
##  ####  ######      ####    ##
##    ##      ##  ##    ####  ##
##  ##  ####      ####        ##
##  ##      ######    ######  ##
##  ##  ##        ##  ##    ####
##  ####    ####  ##    ##    ##
##        ##  ##    ##    ##  ##
####  ####      ##  ####      ##
######      ##  ##      ##  ####
####    ####  ##  ####  ##    ##
##    ##            ##      ####
##  ##    ##  ####    ####  ####
##      ##        ##            
################################
