################################
    ##          ##            ##
##    ##  ##  ##    ####  ##  ##
####    ####  ##  ######    ####
##  ##        ##    ##  ##  ####
##  ##  ##  ####  ##    ##    ##
##  ##  ##        ##  ##  ##  ##
##  ##    ##########        ####
##    ##              ####    ##
##  ##  ######  ######    ##  ##
##            ##      ##      ##
##  ##  ####      ##  ##  ######
##    ##      ######  ##  ##  ##
####    ######      ####      ##
######          ##        ##    
################################
