################################
            ##            ##  ##
##  ####  ##    ##  ####      ##
##    ######  ##  ####  ####  ##
##  ##        ##          ##  ##
##      ######  ##  ####      ##
##  ####    ##  ##    ##  ######
##  ##  ##      ####    ##    ##
##  ##      ##      ##    ##  ##
##  ##  ##  ##  ##    ####    ##
##  ####    ##########      ####
##      ##      ##      ##    ##
##  ##    ####      ##    ##  ##
##  ####    ##########  ####  ##
##      ##              ##      
################################
