################################
            ##      ##      ####
##  ##  ##    ##  ##    ##    ##
##  ##    ##  ##      ######  ##
##  ##  ####    ######  ##    ##
##  ##  ##  ##              ####
##  ##  ##  ######  ##  ##    ##
######  ##        ##      ##  ##
##      ##  ##  ##    ####  ####
##  ####    ##      ##        ##
##    ########  ##    ##  ##  ##
##  ##        ######    ##    ##
##  ##  ####  ####    ##    ####
##  ##  ####      ######  ##  ##
##          ####                
################################
