################################
        ########              ##
##  ##    ####    ######  ##  ##
##    ##        ####  ##    ####
####    ########        ##    ##
####  ##      ####  ##    ##  ##
##      ##  ##      ##  ##    ##
##  ####        ##    ####  ####
##      ##  ##  ####  ##    ####
##  ##    ##      ##    ##    ##
####    ##    ####  ##    ##  ##
##    ##    ##      ####  ##  ##
##  ##########  ####  ##  ##  ##
##  ####        ##        ##  ##
##        ##  ##    ####        
################################
