################################
      ##            ##        ##
##  ####  ##  ####    ####  ####
##  ##    ##  ######    ##    ##
##      ####    ##  ##    ##  ##
##  ######  ##  ##    ##  ##  ##
##          ##    ##          ##
##  ##  ####  ##  ##########  ##
##    ##      ##          ##  ##
####  ##  ##  ####  ####  ##  ##
####  ##    ##        ##  ######
##      ##    ##  ##  ##      ##
##  ##    ##    ##  ####  ##  ##
##  ####    ##  ##      ####  ##
##      ##  ##      ##          
################################
