################################
        ##        ##        ####
##  ##      ####    ##  ##    ##
##  ####  ##  ##  ##      ##  ##
##      ##        ##  ##  ##  ##
##  ##  ##  ##  ########  ##  ##
##  ##  ##    ##  ##      ##  ##
####    ####  ##      ####    ##
##    ##      ####  ##    ##  ##
##  ######  ##        ##  ##  ##
##    ##        ######        ##
####    ########      ##  ##  ##
##    ##          ##    ##  ####
####      ########  ##  ##  ####
##    ##            ##          
################################
