################################
      ##  ##            ####  ##
##  ##      ##  ######        ##
##      ##      ##    ##  ##  ##
####  ##  ##  ##  ##    ####  ##
##    ##      ##      ##      ##
##  ##    ####  ####      ##  ##
##  ####  ####    ####  ##  ####
##    ##      ##        ##    ##
##  ##  ####    ######    ##  ##
##  ##      ##        ##      ##
##    ##  ##  ######  ######  ##
####  ##          ##        ####
####  ######  ##  ##########  ##
##            ##                
################################
