################################
                ##        ##  ##
##  ##  ######      ##  ##    ##
##  ##        ##  ####      ####
##  ########  ####    ####    ##
##        ##      ##      ##  ##
####  ##    ####  ##  ##      ##
##  ##  ##    ##    ##  ########
##      ##  ##  ##            ##
##  ##  ##  ##    ##  ######  ##
##  ##  ##    ##    ##        ##
##  ##    ##      ##    ########
##  ####  ######    ####      ##
##    ####      ##      ####  ##
####        ##      ##          
################################
