################################
    ##  ##            ##  ##  ##
##        ####  ##  ##        ##
####  ##  ##    ##      ##  ####
##    ##    ####    ##  ##    ##
##  ######  ##    ##  ######  ##
##    ##    ##  ##      ##    ##
##  ##    ##  ##    ##      ####
##  ##  ##        ##  ####    ##
##  ##    ####  ##      ##  ####
##  ####    ##    ####  ##    ##
##      ##      ##  ##    ######
##  ##  ####  ##      ##      ##
##  ##      ####  ##    ####  ##
##    ####          ##          
################################
