################################
    ##        ##    ##        ##
##    ##  ##    ##      ####  ##
####  ##    ##  ##  ####  ##  ##
####  ##  ####  ##        ##  ##
##    ##  ##      ##  ##  ##  ##
##  ##    ##  ####      ####  ##
##  ##  ##    ##    ####      ##
##    ####  ##    ##      ##  ##
##  ##      ##  ##  ####    ####
##  ##  ####    ##      ##  ####
##  ##  ##    ##    ##  ##    ##
##      ######    ####  ####  ##
##  ####        ##        ##  ##
##        ##  ##    ####        
################################
