################################
    ######          ##  ##    ##
##    ##    ##  ##  ##      ####
####      ##    ##    ##  ##  ##
##    ##  ####    ##  ##      ##
########      ##  ##  ##  ######
##      ##  ##    ##  ##      ##
##  ##    ##    ##    ##  ##  ##
##    ##    ##  ##  ######    ##
####    ##      ##    ##    ####
##    ##    ####  ##    ##    ##
####    ####        ##  ##  ####
##  ##        ####  ##        ##
##  ##  ######  ##    ######  ##
##                ####          
################################
