################################
                      ##      ##
##  ##  ####  ##  ##      ##  ##
####      ##  ##    ######    ##
##    ##  ##    ####      ##  ##
##  ##    ##  ##      ####  ####
##    ####    ##  ####        ##
####    ##  ##    ##    ####  ##
##    ####    ##    ########  ##
##  ##    ##    ##      ##    ##
##      ##  ##  ##  ##      ####
######  ##  ##    ##  ####  ####
##  ##        ##      ####    ##
##  ########  ####  ##      ####
##              ##      ##      
################################
