################################
          ##  ##            ####
####  ####      ##  ##  ##    ##
####        ##      ##    ##  ##
##    ############    ######  ##
##  ##      ##  ##  ##      ####
##      ####    ##      ##    ##
######        ##  ##  ######  ##
##    ######  ##    ##  ##    ##
##  ##        ##  ##      ##  ##
##      ########  ##  ##  ##  ##
##  ######        ##  ##  ##  ##
##        ####  ##    ##  ##  ##
####  ##    ##  ##  ####  ##  ##
##      ##        ##            
################################
