################################
        ##    ##          ##  ##
##  ##    ##    ##  ####      ##
##    ####  ##      ##    ##  ##
####    ##    ##  ##    ##    ##
##  ##  ####    ##  ##    ##  ##
##          ##      ####  ##  ##
##  ######    ####    ##  ##  ##
####        ####  ##  ##    ####
####  ####  ##    ##    ##    ##
##    ##        ##  ##    ##  ##
##  ##########        ##      ##
##    ##      ####  ####  ##  ##
####  ##  ##    ####        ####
##          ##        ####      
################################
