################################
        ##      ##  ##        ##
##  ####    ##          ####  ##
##  ####  ##  ##  ##  ##  ##  ##
##            ####    ##      ##
##  ##  ######      ##    ##  ##
##    ####      ####    ##    ##
##  ##      ##  ##    ####  ####
##  ##  ####  ##    ##        ##
####      ##      ##  ##  ##  ##
####  ####    ####      ##    ##
##    ##    ##      ##  ##  ####
##  ##    ##  ##  ##  ####  ####
##    ####        ##  ##      ##
####        ##  ##        ##    
################################
