################################
    ##        ##  ##  ######  ##
##      ####  ##        ##    ##
##  ####  ##  ##  ####      ####
##  ##    ##    ##  ##  ##    ##
##  ##  ##  ##  ##        ##  ##
##          ##  ##  ####  ##  ##
####  ##  ####  ##  ##  ####  ##
####    ##      ####          ##
##  ##    ######      ##  ##  ##
##  ##  ##    ##  ##  ##    ####
##      ####      ##  ####    ##
##  ####    ####  ##      ##  ##
##  ##  ##      ##  ##  ####  ##
##          ##          ##      
################################
