################################
            ##  ##        ##  ##
####  ####  ##      ##  ##    ##
##    ##        ####  ##    ####
####  ##  ##  ####        ######
##      ##  ##      ##  ########
##  ####        ##  ##    ######
##  ##    ##########  ##    ####
##  ##  ##      ##      ##    ##
##          ####    ##    ##  ##
####  ####        ######  ##  ##
##  ##    ##  ####  ##  ##    ##
##    ##    ##            ##  ##
####  ####  ##  ########      ##
##              ##        ##    
################################
