################################
            ##      ##      ####
##  ####  ##    ##  ##  ##    ##
##  ##        ##        ########
####    ######  ####  ##      ##
##    ##                ####  ##
####  ##  ##  ######  ##  ##  ##
####  ##    ##      ##    ##  ##
##    ##  ##    ##      ####  ##
##  ######    ##    ##  ##    ##
##  ####    ####  ##  ##    ####
##        ##      ##      ##  ##
####  ####    ######  ####    ##
##        ##  ##            ####
##  ####  ##      ####  ##      
################################
