################################
          ##            ##    ##
##  ####      ##  ####      ####
##    ########    ##  ####    ##
####        ##  ##      ####  ##
##  ######  ##      ##    ##  ##
##  ##      ######    ##  ##  ##
##      ####      ####    ##  ##
##  ##    ##  ##        ##    ##
##    ####    ##  ##  ##  ##  ##
######      ##      ##      ####
##      ####  ####    ####    ##
##  ####          ##    ##  ####
##  ##    ##  ##    ####      ##
##      ##      ##        ##    
################################
