################################
      ##  ##  ##        ##    ##
####              ####    ##  ##
####  ####  ##  ##  ####  ##  ##
##      ##  ####              ##
########        ##  ##  ####  ##
##      ##  ##    ##    ##    ##
##  ##  ##    ##    ##    ##  ##
##  ##  ####  ####  ####    ####
##  ##    ##    ##      ##    ##
##  ####  ####    ####    ##  ##
####  ##      ####      ##    ##
##      ####        ##  ##  ####
##  ##      ########  ##      ##
##    ####                ##    
################################
