################################
      ####                    ##
####        ##  ####  ##########
##    ########      ##        ##
####  ##      ####      ####  ##
##      ##  ####    ####  ##  ##
##  ##      ##  ####          ##
##  ####  ##    ####  ######  ##
##    ######  ##      ##      ##
######        ####  ##    ######
##      ######      ##  ##    ##
##  ######    ##  ####    ##  ##
##        ##      ##  ##      ##
####  ##    ##  ##    ######  ##
##      ##        ##            
################################
