################################
      ##      ##          ######
####      ##  ##  ######    ####
##  ##  ####  ##  ##    ##    ##
##      ##    ##    ##    ######
##  ##    ##    ##    ##      ##
##    ##    ##  ##  ##    ##  ##
##  ####  ##  ##    ####  ##  ##
####      ##      ##      ##  ##
##    ##    ##  ##    ####    ##
####    ##  ##    ##      ##  ##
##    ##    ##  ##    ######  ##
####  ########    ####        ##
####          ##  ####  ####  ##
##    ##  ##            ##      
################################
