################################
                    ##        ##
##  ##  ##  ######  ##  ########
##  ##    ##        ##        ##
##  ##  ##    ######    ####  ##
##  ##    ##        ####      ##
##    ##    ######  ##    ##  ##
######    ##    ##  ##  ##    ##
##      ##  ##  ##  ##    ######
##  ####              ##      ##
##    ######  ##  ####  ####  ##
####        ##            ##  ##
##    ####    ##  ######      ##
##  ##    ##    ##      ####  ##
##    ##      ##    ##          
################################
