################################
          ##              ##  ##
##  ######    ####  ##  ##    ##
##      ##  ####  ##        ####
##  ##  ##  ##      ######  ####
####    ##  ##  ##  ##        ##
##    ##    ####    ##  ####  ##
####    ##      ##  ##      ####
##  ##    ####        ####    ##
##    ##    ##########    ##  ##
##  ##    ##            ##    ##
##      ##    ##  ####  ##  ####
##  ##  ##  ##      ##  ##    ##
##    ##      ####    ##  ##  ##
####      ##      ##            
################################
