################################
    ##      ##      ##        ##
##      ##      ##    ######  ##
##  ####  ####    ####    ##  ##
##  ##      ####      ##  ##  ##
##      ##      ##  ####      ##
########    ##  ##  ##  ####  ##
##        ##  ##        ##    ##
##  ##  ####  ##  ##  ##    ####
##    ####    ##    ####  ##  ##
####        ######  ##    ##  ##
##  ######    ##    ##  ##    ##
##  ##      ##    ####  ####  ##
##      ####  ##          ##  ##
##  ##          ##  ####        
################################
