################################
            ##        ####    ##
####  ####    ##  ##        ####
##        ##    ##    ##  ######
##  ####    ##      ####    ####
##  ##  ####    ####    ##    ##
####        ##        ##  ##  ##
####  ####    ##  ######      ##
##        ##  ####      ##  ####
##  ######          ##  ##    ##
##        ######  ####    ##  ##
##  ####        ##    ##  ##  ##
##      ####  ##    ##        ##
##  ####  ##  ##  ##  ####  ####
##        ##      ##            
################################
