################################
      ##      ####    ##      ##
####  ##  ##        ##    ##  ##
##    ##  ##  ##  ##    ##    ##
##  ##    ##    ##    ##  ##  ##
##  ####    ##      ##    ##  ##
##    ##  ##  ######    ##    ##
####  ##              ##    ####
##      ############  ##  ##  ##
##  ##  ##          ##    ##  ##
##  ##    ##  ####    ##  ##  ##
##  ####          ######  ##  ##
##      ##########        ##  ##
##  ##          ##  ########  ##
##    ##  ####                  
################################
