################################
            ##          ##    ##
##  ######  ##  ##  ####    ####
##      ##  ##  ##        ##  ##
######  ##        ######      ##
##      ##  ##  ##      ####  ##
##  ####  ##    ##  ##    ##  ##
##  ##    ##  ##      ##    ####
##  ####      ##  ##    ##    ##
##      ##  ##      ####  ##  ##
##  ##  ##  ####  ##          ##
##  ##    ##        ######  ####
##    ##  ##  ##  ##      ##  ##
##  ####        ##    ##  ##  ##
##      ##  ##      ##          
################################
