################################
          ##      ##          ##
######  ##    ##    ##  ##  ####
##      ##  ######    ##      ##
##  ####      ##  ##      ##  ##
##    ##  ##  ##    ####  ##  ##
####      ##    ##    ##    ####
##    ####  ##    ##    ##    ##
##  ##        ##      ####  ####
##    ##  ##    ##  ##      ####
####  ##  ####    ##    ##    ##
####  ##      ##  ##  ######  ##
##      ##  ##    ##    ##    ##
##  ####  ####  ##  ##  ########
##                  ##          
################################
