################################
    ##        ##      ##########
##    ##  ##      ##    ########
####    ########    ##    ######
######    ##      ######    ####
########  ##  ##    ######    ##
########  ##    ##    ##    ####
######    ##  ##  ##    ##    ##
####    ####      ####    ##  ##
##    ##      ##      ##    ####
##  ####  ##  ######    ##    ##
##  ##      ##      ##  ##  ####
##  ##  ####    ##  ##  ##    ##
##  ####      ####  ##  ##  ####
##        ####          ##      
################################
