################################
    ##    ####  ##    ##  ##  ##
##      ##      ####          ##
##  ####    ####      ######  ##
##    ##  ####    ####    ##  ##
##  ####      ##    ##  ##    ##
##      ####    ##      ####  ##
##  ##  ######    ####    ##  ##
##  ##    ##  ##  ##  ##  ##  ##
##  ####          ##      ##  ##
##    ####  ##  ##    ####    ##
####      ##  ##  ##      ##  ##
##  ####  ##        ######    ##
##  ##      ##  ##  ##      ####
##      ##      ##      ##      
################################
