################################
        ##  ####      ##  ##  ##
##  ####          ##          ##
##    ##  ########    ####  ####
##  ##    ##      ####      ####
##      ####  ##        ####  ##
##  ######    ##  ######  ##  ##
##  ##    ####  ##            ##
##    ##            ########  ##
####  ##  ####  ####      ##  ##
##            ##      ##  ##  ##
##  ######  ##    ##    ####  ##
####      ##    ##  ##  ##    ##
##    ##      ####  ##    ##  ##
##  ##    ##          ##        
################################
