################################
    ##      ####        ##  ####
##      ####      ####        ##
####  ####    ######  ######  ##
####        ####      ##      ##
##    ######      ##  ##  ##  ##
##  ##        ##    ##    ##  ##
##      ########  ##    ####  ##
####  ####      ##    ##      ##
######      ##    ##    ##  ####
######  ####  ##  ####    ######
####    ##    ##      ##    ####
##    ##  ##    ####    ##    ##
##  ####    ##      ##  ####  ##
##        ##    ##              
################################
