################################
          ##  ##  ##          ##
######  ##        ##  ##  ##  ##
##          ##  ##    ##  ##  ##
##  ##  ##    ##    ##    ##  ##
##    ######  ##  ####  ##    ##
####    ######    ##    ##  ####
##  ##    ##    ####  ####  ####
##    ##  ##  ##      ##      ##
##  ####  ##    ##  ##    ##  ##
##        ##  ####    ##    ####
######  ####      ##    ##    ##
##      ##  ##  ##    ######  ##
##  ####        ##  ##  ####  ##
##        ##  ######            
################################
