################################
    ##  ##            ##      ##
##        ##  ##  ##  ##  ##  ##
##  ####  ####    ##  ##  ##  ##
##  ##        ##  ##  ##  ##  ##
##    ######      ##  ######  ##
####      ##  ######          ##
##    ##    ##      ##  ####  ##
##  ##  ##      ##    ##      ##
##  ##    ######    ##  ##  ####
##      ##        ##    ##  ####
##########  ##  ##    ####    ##
##          ######  ##    ##  ##
##  ########        ##  ####  ##
##            ##  ##            
################################
