################################
            ##      ##        ##
####  ####    ##  ##    ####  ##
##    ######  ##    ##  ##    ##
####    ##      ##        ##  ##
##  ##  ##  ##  ##  ####  ##  ##
##      ##  ##  ##  ##  ##    ##
##  ########    ##      ##  ####
##      ##    ##    ##  ##    ##
######  ####    ######    ##  ##
##  ####    ##        ##  ##  ##
##        ##  ######    ####  ##
##  ##  ##            ##      ##
##  ##  ##  ############  ##  ##
##  ##                    ##    
################################
