################################
          ##    ##            ##
####  ##  ####      ####  ##  ##
##    ##    ##  ####    ##    ##
##  ##    ##        ##  ##  ####
##  ####    ######      ##    ##
##      ##        ##  ##    ####
##  ##    ##  ##    ##    ##  ##
##    ##    ######    ##      ##
####    ##    ##  ##      ##  ##
##    ##    ##      ######    ##
##  ##    ##    ##        ##  ##
##    ##      ####  ##  ##    ##
##  ##  ######    ##    ##  ####
##            ##      ##        
################################
