################################
            ##                ##
####  ####    ##  ##  ##  ##  ##
####  ##    ##    ####    ##  ##
##    ##  ##  ##    ##  ##    ##
##  ##          ##  ##  ##  ####
##    ####  ####    ##    ######
####  ##  ##      ##  ##    ####
##        ##  ####      ##    ##
##  ##  ##    ##  ####    ##  ##
##  ##    ##  ##        ##  ####
##    ##  ##      ####      ####
####  ##    ##  ##    ####    ##
##    ##  ##  ##  ##      ##  ##
##  ##                ##        
################################
