################################
    ##      ##        ##  ######
##      ####    ##  ##      ####
##  ####      ####      ##    ##
##  ####  ######  ####  ####  ##
##        ##          ##      ##
##  ######  ##  ####  ##  ##  ##
##      ##        ##  ##    ####
######  ##  ##  ##      ##  ####
##  ##    ##    ##  ##  ##    ##
##    ##  ##  ######    ####  ##
##  ####  ##    ##    ##      ##
##        ##  ##    ##    ##  ##
####  ######    ##  ####  ##  ##
##            ##        ##      
################################
