################################
                ####        ####
##  ##  ##  ####      ####    ##
##    ##    ##    ####    ######
##  ##    ##    ##      ##    ##
##  ##  ##  ##  ##  ####  ##  ##
##  ##      ##  ##            ##
##    ##  ##    ##  ##  ##  ####
####  ##    ##    ##    ##    ##
####  ##  ##  ##  ##  ##    ####
##    ##      ##        ##    ##
####  ##  ##############  ##  ##
##    ##      ##          ##  ##
##  ##  ####    ##  ##  ####  ##
##          ##      ##          
################################
