################################
      ##          ##        ####
####      ##  ##  ##  ####    ##
##  ##  ##      ##        ##  ##
##      ##  ####    ##  ##    ##
####  ##  ##      ##  ##    ####
##    ##      ####        ##  ##
####      ####    ##  ##  ##  ##
##    ####  ####    ##    ##  ##
##  ##          ##  ##  ####  ##
##    ########  ##  ##  ##    ##
####        ##        ##    ####
##  ##  ##    ##  ##  ####    ##
##    ####  ####  ##    ####  ##
####                ##          
################################
