################################
              ##  ##          ##
####  ########        ######  ##
##    ##        ######        ##
####      ######      ##  ##  ##
##  ####          ####    ##  ##
##      ######  ####    ####  ##
##  ##        ##      ##      ##
##    ##  ##      ####    ######
##  ######  ########  ##  ##  ##
##    ##    ##        ##      ##
####  ##  ######  ##    ####  ##
##    ##    ##    ####  ##    ##
##  ##  ##    ##      ####  ####
##          ##    ##            
################################
