################################
    ##                ##      ##
##  ##  ####  ####  ##    ##  ##
##      ##        ####  ##    ##
##  ######  ##  ##      ##  ####
##  ##        ##    ####    ####
####    ####  ##  ##    ##    ##
##    ##  ##  ##  ####  ##  ####
##  ##      ##      ##  ##    ##
##    ####  ##  ##  ##    ##  ##
####  ####    ##      ##      ##
##        ##    ####  ##  ######
##  ##  ##  ##        ##  ##  ##
##  ##        ########        ##
##    ##  ##            ####    
################################
