################################
    ######  ##            ##  ##
##    ##      ####  ####      ##
####      ##        ##  ####  ##
##  ##  ##  ########      ##  ##
##      ##  ##      ####      ##
##  ##  ##    ##  ##      ######
##  ##    ##      ##  ####    ##
##  ##  ####  ##  ##    ##  ####
##  ##      ##      ##      ####
##  ######    ##  ##    ##    ##
####      ##  ##    ####    ####
####  ####    ##  ##      ##  ##
##          ####      ######  ##
##  ####  ##      ##            
################################
