################################
                ##            ##
####  ####  ##  ##  ##  ####  ##
##    ##      ##    ####      ##
##  ##  ####    ##      ##  ####
##  ##        ########  ##  ####
##  ########    ##  ####      ##
##          ####        ####  ##
##  ##  ##    ##  ####        ##
##    ##    ##    ##  ##  ######
##  ##    ##    ##    ####    ##
##  ##  ######    ##        ####
##  ##    ##    ##  ##  ##    ##
##    ##    ##      ##    ##  ##
####    ##      ##      ##      
################################
