################################
                  ##          ##
##  ######  ####  ##  ##  ##  ##
####        ##      ##    ##  ##
##    ######    ##  ##  ####  ##
##  ##      ##    ##    ##    ##
####    ##    ##      ####  ####
##    ##  ##  ####  ##      ####
##  ##    ##      ##    ####  ##
##  ##  ######  ##    ##      ##
##        ##      ##    ####  ##
####  ##    ##  ##  ##        ##
##      ##  ##        ##  ##  ##
##  ##    ##  ##  ####      ####
##    ##      ##        ##      
################################
