################################
    ##          ##          ####
##    ##  ####      ######    ##
####    ####    ##      ####  ##
##  ##        ##  ####    ##  ##
##  ##  ##  ####      ##    ####
##      ####      ##  ####    ##
##  ##      ##  ####      ##  ##
####    ##  ##      ##  ####  ##
##    ##      ######    ##    ##
##  ##    ##          ##    ####
####    ########  ######  ######
##    ##  ##    ##        ######
##  ####    ##      ####    ####
##        ##    ##      ##      
################################
