################################
    ######            ##      ##
##    ##    ########      ##  ##
####  ##  ####    ####  ##    ##
####      ##    ##      ##  ####
##    ####    ##    ####      ##
##  ##      ##    ##      ##  ##
##  ##  ####    ##  ##  ##  ####
####    ##    ####      ##    ##
####  ##    ####    ########  ##
##    ####      ##      ##    ##
####      ####    ####  ####  ##
##  ####      ##    ##        ##
##    ####  ####  ##  ######  ##
####              ##            
################################
