################################
      ##          ##          ##
##  ##    ##  ##  ##  ######  ##
##  ##  ####    ##        ##  ##
##          ##  ##  ##  ##    ##
####  ##  ##    ##    ##    ####
##      ##    ######  ##  ##  ##
##  ######  ##  ##    ##  ##  ##
######          ##  ######    ##
##      ####  ##      ##  ##  ##
##  ######      ####  ##      ##
##  ##      ####      ####  ####
##    ######      ####  ##    ##
##  ##      ####  ####      ####
##      ##              ##      
################################
