################################
            ##                ##
##  ##  ##    ##  ##  ##  ##  ##
####    ####    ##      ##  ####
####  ##    ##  ##  ##        ##
##    ##  ##    ##    ##  ##  ##
##  ##      ##    ####    ##  ##
##      ####  ##  ##    ##    ##
##  ####      ##    ##    ##  ##
####      ####  ##    ####    ##
##    ##        ##  ##      ####
##  ##  ##  ##  ##      ##    ##
##  ##      ##  ############  ##
##    ####    ##        ####  ##
####      ##      ####          
################################
