################################
      ##  ##      ##          ##
##  ##        ##      ##  ##  ##
##  ##  ##  ##  ####  ##  ##  ##
##  ##    ####      ####  ##  ##
##  ####        ####      ##  ##
##    ####  ####      ####    ##
####    ##    ##  ######    ####
##  ##    ##  ##        ##    ##
##      ####    ##  ##  ####  ##
##  ##      ##  ##  ##      ####
##    ##  ##      ##  ####    ##
##  ####      ####      ##  ####
##      ######      ##      ####
##  ##  ##      ####    ##      
################################
