################################
    ##      ##  ##            ##
##      ##      ##  ####  ##  ##
##  ##  ##  ######    ##    ####
####    ##  ##      ##  ##    ##
##    ##    ##  ####      ##  ##
########  ##          ##  ##  ##
##        ##  ########    ##  ##
##  ####    ##          ####  ##
##      ######  ##  ##  ##    ##
##  ##            ######    ####
##  ########  ##    ##    ##  ##
####        ##  ##  ##  ##    ##
##    ####        ####      ####
##  ########  ##        ##      
################################
