################################
    ##    ##      ##          ##
##      ##    ##      ##  ##  ##
####  ##  ##    ####  ##    ####
##        ####      ##  ##    ##
##  ####      ##  ##    ##  ####
##    ####  ##  ##    ####    ##
####    ##        ##  ##    ####
##  ##  ########      ##  ##  ##
##  ##          ####  ##      ##
##    ####  ##  ##      ####  ##
####    ##    ##    ##    ##  ##
##    ##  ##  ##  ##  ####    ##
##  ####      ##          ##  ##
##        ##    ##  ####        
################################
