################################
      ##                ##    ##
####      ######  ##  ##    ####
##    ##      ##  ##  ##  ##  ##
##  ##  ######    ##      ##  ##
##  ##      ##  ##  ####      ##
######  ##      ##      ####  ##
##        ######    ##        ##
##  ######    ##  ########  ####
##        ##  ##    ##    ######
########  ##      ##  ##  ######
##        ######      ##    ####
##  ######      ######  ##    ##
##      ##  ##  ##      ####  ##
##  ##      ##      ##          
################################
