################################
    ##  ##            ####    ##
##          ##  ##  ##      ####
##  ####  ##    ####    ##    ##
##    ##    ##    ##  ##  ##  ##
####  ####  ####  ##  ##  ##  ##
####    ##    ##  ##  ##      ##
##  ##    ##  ####    ##  ######
##    ##  ##    ##  ####  ##  ##
##  ####  ####    ##      ##  ##
##          ####  ##  ####    ##
##  ####  ##      ##        ####
##      ##    ##    ####  ######
######  ##  ##  ######      ####
##      ##              ##      
################################
