################################
            ##                ##
##  ##  ##      ##  ########  ##
####    ####  ##    ##    ##  ##
##    ##    ##  ##  ####      ##
##  ####  ##    ##    ##  ##  ##
##  ##        ##  ##    ####  ##
##      ####  ##    ##  ##    ##
####  ##  ##      ####    ##  ##
########    ####  ##    ##    ##
####    ##        ##  ####  ####
##    ##    ##  ##    ##    ####
##  ##  ######  ##  ##    ##  ##
##  ##        ##    ##  ####  ##
##      ####      ##            
################################
