################################
      ##      ##  ##  ##      ##
##  ##    ##              ##  ##
##  ##  ##  ######  ######    ##
##          ##      ##      ####
##  ##  ######  ####    ####  ##
##    ##        ######  ##    ##
####  ##  ######  ##    ##  ####
######    ##      ##  ####    ##
####    ##  ##  ##          ####
##    ##            ########  ##
##  ##    ##  ######          ##
##    ##    ##        ##########
####  ########  ########      ##
##                        ##    
################################
