################################
      ##    ##        ##      ##
####    ##      ########  ##  ##
##  ##      ##            ##  ##
##      ##    ##  ##  ##  ##  ##
##  ##    ####  ##      ##    ##
##  ##  ##      ##  ##  ##  ####
##    ####  ########  ####    ##
##  ##      ##  ##          ####
####    ####        ##  ##  ####
##    ##  ######  ##  ####    ##
##  ##            ##      ##  ##
##    ####  ######  ##  ##    ##
####    ##  ##  ##          ####
######      ##      ##  ##      
################################
