################################
                    ####  ##  ##
##  ####  ########            ##
##      ##        ####  ####  ##
######  ##  ####  ##    ##    ##
##        ##  ##  ##  ##    ####
##  ######        ##    ##  ####
####        ######  ##  ##    ##
##    ######              ##  ##
##  ##      ##  ########  ##  ##
##  ######      ##      ##    ##
##        ####    ##  ##    ####
########    ##  ##    ##  ##  ##
##    ##  ##    ####      ##  ##
####          ##      ##        
################################
