################################
      ##      ##      ##      ##
####      ######  ##    ####  ##
####  ##            ##    ##  ##
##      ##  ######    ##      ##
##  ######        ######  ##  ##
####      ####  ##      ##    ##
##    ##      ####  ##  ##  ####
##  ##    ##  ##    ##  ##    ##
##    ##  ##      ##    ####  ##
####    ##########  ####      ##
######    ##              ##  ##
########    ##  ##  ######    ##
##########    ##    ##      ####
############      ##    ##      
################################
