################################
              ##        ##    ##
##  ########    ##  ##  ##  ####
####        ##    ##    ##    ##
##    ####    ##    ##    ##  ##
##  ##  ##  ##    ##    ##    ##
##  ##          ##  ##  ##  ####
##    ##########    ##      ####
##  ##            ##  ####    ##
##      ########        ####  ##
##  ##  ##    ####  ##    ##  ##
##  ####    ##      ##  ##    ##
##        ##    ##    ####  ####
########  ####  ######        ##
##          ##          ####    
################################
