################################
    ##              ##        ##
##  ##  ##########    ##  ##  ##
##  ##            ##      ##  ##
##    ##  ##  ##  ######    ####
####    ##      ##      ##    ##
##    ####  ##  ##  ##    ##  ##
##  ##        ##      ##  ##  ##
##  ##  ####  ##  ##  ##      ##
##          ##      ##    ##  ##
##  ####  ####  ####    ##  ####
##      ##      ##    ####    ##
######  ##  ####  ##      ##  ##
##  ##  ##  ##      ####  ##  ##
##      ##      ####            
################################
