################################
    ####      ##      ####    ##
##        ##      ####      ####
######  ##  ####    ##  ####  ##
##      ##        ##    ##    ##
##  ####    ##  ##    ######  ##
##    ##  ########  ##  ####  ##
####  ##    ##      ##        ##
##    ##  ##    ####    ##  ####
##  ##    ##  ####    ####    ##
##    ##  ##      ##      ##  ##
####  ####  ####    ######    ##
##              ##  ##      ####
####  ########          ##    ##
##            ##  ####    ##    
################################
