################################
          ##      ##  ##    ####
##  ####      ####      ##    ##
######    ##    ##  ##    ##  ##
##      ########      ##      ##
##  ####  ##      ##    ####  ##
##            ######  ####    ##
##  ####  ####      ##      ####
##      ##      ##      ########
######    ##  ##########    ####
##    ##  ##    ##        ##  ##
##  ##    ####      ##  ##    ##
##      ##    ##  ##  ##  ##  ##
##  ######  ##  ##        ##  ##
##                  ####        
################################
