################################
          ##          ####    ##
##  ##  ####  ##  ##        ####
####    ##      ##  ####  ##  ##
##    ##    ####      ##  ##  ##
##  ##    ####    ##  ##      ##
##    ##        ##      ##  ####
####    ##  ####    ##  ##  ####
##    ####    ######  ##      ##
##  ##      ##          ####  ##
##      ####    ##  ##    ##  ##
##  ####    ####  ##  ##      ##
##  ##    ##  ##        ########
##    ##        ####  ##      ##
####      ####            ##    
################################
