################################
        ##    ##      ##  ##  ##
##  ##    ##      ##          ##
####  ##    ##  ##  ########  ##
##      ##                  ####
##  ##  ##  ##  ######  ##    ##
##  ##    ##          ##    ####
##    ##  ##  ########    ##  ##
##  ##  ##  ##        ##      ##
##  ##  ##    ##  ##      ##  ##
##        ##        ##  ####  ##
####  ##  ##  ####    ##      ##
##  ##    ##      ##  ##  ######
##      ##  ######    ##      ##
##  ##              ##    ##    
################################
