################################
      ##        ##    ######  ##
####      ########  ##  ##    ##
####  ##            ##      ####
##    ########  ####  ##  ##  ##
##  ##        ##      ##      ##
##    ##  ##      ##  ######  ##
####    ####  ##  ##      ##  ##
##  ##  ##    ##    ####      ##
##  ##    ##    ##    ##  ##  ##
##    ##    ##    ##    ####  ##
##  ####  ##  ##    ##  ##    ##
##            ##  ##    ##  ####
##  ########    ##    ####  ####
##          ##      ##          
################################
