################################
        ####        ##      ####
##  ##        ##  ##    ##    ##
##  ######  ####  ##  ##  ##  ##
####        ##    ####    ##  ##
##    ##  ##  ##        ##    ##
####    ##      ##  ##      ####
##  ##  ##  ##    ##  ####    ##
##  ##  ##    ##      ##  ##  ##
##  ##    ##    ####      ##  ##
##    ##    ####      ####    ##
####    ####      ##    ##  ####
##  ##    ##  ##  ##  ####  ####
##  ####      ##  ####        ##
##        ##  ##        ####    
################################
