################################
    ######  ##            ##  ##
##    ##    ##  ##  ####  ##  ##
####      ##    ##  ##        ##
####  ##      ##    ##  ####  ##
##    ######    ##    ####    ##
##  ##      ####  ##  ##    ####
##  ######        ##  ##  ##  ##
##        ##  ####    ##      ##
####  ##      ##    ##  ##  ####
##    ##########  ##    ##    ##
##  ##            ##  ##    ####
##  ##  ##########    ##  ##  ##
####    ##        ##  ##  ##  ##
##    ##    ####                
################################
