################################
        ##    ##              ##
##  ##    ##      ##  ####  ####
##  ####    ##  ##      ##    ##
##      ##    ##    ##  ##  ####
####  ##  ##    ##    ##      ##
##    ##    ####  ####    ##  ##
##  ##    ##          ##    ####
##      ##    ##  ##    ##    ##
######  ##  ####    ##      ####
##  ##    ##      ##    ##    ##
##    ##      ####  ##  ##  ####
##  ##  ####  ##      ##      ##
##  ##      ##    ##    ##  ####
##      ##      ######          
################################
