################################
        ####      ##          ##
##  ##        ##  ####  ####  ##
##    ####  ##      ##    ##  ##
######  ##    ####      ##    ##
##        ##  ##  ##  ######  ##
##  ######    ##    ##  ##    ##
##        ##  ####          ####
######  ##        ##  ##  ##  ##
##  ##  ##  ####    ##    ##  ##
##  ##    ####    ##    ##    ##
##    ##      ##    ##      ####
####  ##  ##    ##    ####    ##
##      ##  ##      ##    ##  ##
##  ##          ##    ##        
################################
