################################
        ##      ##        ######
##  ##      ##      ####    ####
####    ####    ####  ####    ##
##    ######  ##  ##        ####
##  ##  ##    ##    ##  ##    ##
##      ##  ##  ##    ##  ##  ##
####  ##        ##  ##      ####
####  ##  ####  ##      ##    ##
##    ##  ##    ##  ########  ##
##  ####  ##  ##  ##    ##    ##
####      ##          ##    ####
##    ####  ##########    ##  ##
####  ##            ##  ####  ##
##        ##  ####              
################################
