################################
      ##              ##########
##  ##    ####  ####    ########
##    ##      ####  ##    ######
####    ####        ####    ####
##    ##    ######      ##    ##
####      ##    ##  ##    ##  ##
##  ##  ##    ##      ##  ##  ##
##        ##      ####  ##    ##
##  ##  ####  ####          ####
##    ##        ##  ####  ##  ##
####  ##  ######    ##  ##    ##
##    ##      ##  ##      ##  ##
####    ##  ##  ####  ##  ##  ##
######                ##        
################################
