################################
        ##          ##        ##
##  ##    ##  ##  ##    ####  ##
##    ##      ##      ####    ##
####  ##  ######  ####      ####
######  ##      ####    ##    ##
######  ##  ##  ##    ##  ##  ##
####    ##  ##      ##        ##
##    ##    ########    ##  ####
####    ##          ####      ##
##    ##    ##  ##      ########
####  ##  ##      ####        ##
##      ############    ####  ##
##  ##    ##        ####  ##  ##
##    ##      ####              
################################
