################################
    ##          ##        ##  ##
##  ##  ######      ####      ##
##      ##    ##  ##    ##  ####
####  ####  ####      ##      ##
##    ##        ####    ##  ####
##  ####  ####      ##  ##    ##
##        ##  ##  ##      ##  ##
##########          ####    ####
##        ##  ##  ##    ##    ##
##  ####  ##    ##    ######  ##
####        ##    ##  ######  ##
##    ####    ##  ##    ##    ##
##  ##  ######      ##  ##  ####
##              ##  ##          
################################
