################################
            ##      ##        ##
##  ##  ##    ####      ####  ##
####    ######      ##    ######
##    ##        ####  ##      ##
##  ##    ######        ####  ##
##      ##        ####  ##    ##
##  ####    ####      ##    ####
##      ######    ####    ##  ##
######  ##      ####  ####    ##
##  ##      ##          ####  ##
##    ######  ####  ##    ##  ##
####      ##      ##  ##  ##  ##
##    ##      ##      ##  ##  ##
##  ##    ##    ####            
################################
