################################
    ##        ##          ######
##      ####    ##  ####    ####
####  ##    ##  ##  ##  ##    ##
####      ##    ##  ##  ##  ####
##  ######  ##  ##  ##  ##    ##
##          ##      ##      ####
##  ##  ##  ##########  ####  ##
##    ####              ##    ##
####      ############    ##  ##
##  ##  ##            ####    ##
##  ##  ##  ####  ##        ####
##  ##  ##  ##    ########    ##
##      ####    ##      ##  ####
##  ##        ##    ##          
################################
