################################
    ##  ##  ##        ##    ####
##            ##  ##    ##    ##
##  ########        ##    ##  ##
##  ##    ##########    ##    ##
##  ##  ##        ##  ##  ##  ##
##  ##      ####  ##      ##  ##
##  ##  ####        ####  ##  ##
##  ####      ##  ##    ##    ##
##    ##  ####    ####      ####
####      ##    ##      ##  ####
##  ######  ##      ######    ##
##          ########      ##  ##
##  ####  ##      ##  ##  ##  ##
##    ##      ##      ##        
################################
