################################
                  ##    ####  ##
##  ##  ##  ####    ##        ##
######    ##    ##    ####  ####
##      ##    ##  ##    ##    ##
##  ##  ##  ##      ##    ##  ##
##    ##    ##  ########  ##  ##
######    ##        ##    ##  ##
##  ##  ##    ####    ##  ##  ##
##      ##  ##    ##      ##  ##
##  ##  ##    ##    ######    ##
##  ##      ######      ##  ####
##    ######  ##    ##        ##
####      ##      ##  ######  ##
##    ##      ####              
################################
