################################
    ####              ##  ##  ##
##      ##  ##  ####          ##
##  ##    ##  ##    ##  ####  ##
##    ##        ##        ##  ##
####    ########    ####  ##  ##
##    ##        ##  ##    ##  ##
##  ##    ##  ##    ##  ####  ##
##    ##  ##  ##  ##    ##    ##
####  ##  ##    ##    ##    ####
##    ##    ##    ##    ####  ##
##  ##  ##    ##    ##        ##
##  ##      ##  ##    ##  ##  ##
##    ##  ##      ##  ######  ##
####      ##  ##                
################################
