################################
            ##    ##          ##
####  ####    ##  ##  ####  ####
##    ######  ##        ##  ####
##  ##  ##    ####  ##  ##    ##
##  ##    ##      ##      ##  ##
##    ##  ######    ##  ####  ##
##  ####        ##    ##      ##
##      ####  ##    ##    ######
##  ##  ##        ##  ##      ##
####    ########      ##  ##  ##
##    ##        ####  ##  ##  ##
##  ##    ####    ##  ##  ##  ##
##  ##  ##    ##  ##    ####  ##
##          ##      ##          
################################
