################################
        ##            ##  ##  ##
##  ##  ##  ########          ##
##  ##    ##        ##  ####  ##
##  ####  ##  ####    ####    ##
##    ##      ##  ##      ##  ##
####    ##  ##      ####  ##  ##
##  ##    ##  ####    ##  ##  ##
##  ##  ####  ##  ##  ##  ##  ##
##  ##  ##    ##      ##      ##
##  ##      ##    ####  ##  ####
##  ########    ####    ##    ##
##          ##        ##    ####
##  ##  ####    ##  ####  ##  ##
##  ##        ##                
################################
