################################
              ##              ##
##  ####  ####    ####  ####  ##
####  ##      ##  ##      ##  ##
##      ####      ##  ####    ##
##  ##      ####  ##      ##  ##
##  ######      ####  ##    ####
##        ####  ##    ####    ##
####  ##    ##  ##  ##  ##  ####
##      ##  ##  ##  ##  ##    ##
##  ####    ##  ##        ##  ##
####      ##      ########    ##
##    ####    ##        ##  ####
####      ####  ######      ####
##    ##        ##      ##      
################################
