################################
        ######            ##  ##
##  ##    ##    ####  ##      ##
##    ##    ##  ##    ##  ##  ##
####    ##  ##    ##    ####  ##
##    ####  ####  ####      ####
####  ##      ##      ####    ##
####  ##  ####  ####    ##  ####
##    ##          ##  ##      ##
##  ##    ####  ##      ####  ##
##    ##    ####    ##    ##  ##
####  ######      ##  ##  ##  ##
####          ######    ##    ##
##  ##########      ##      ####
##              ##      ##      
################################
