################################
        ##                    ##
##  ######  ##  ##  ####  ##  ##
##  ##      ##  ##    ######  ##
##  ##  ####    ##  ##      ####
##  ##      ##    ##    ##    ##
##  ##  ##    ##      ##    ####
##  ##    ####  ##  ##    ##  ##
##    ##          ####  ##    ##
##  ##  ####  ##      ##    ####
##          ########  ##  ##  ##
##  ######    ##      ##      ##
##  ##    ##  ##  ##########  ##
##  ##  ####          ##      ##
##          ##  ####      ##    
################################
