################################
      ####        ##        ####
####        ####    ##  ##    ##
##    ####      ##  ##  ####  ##
##  ##    ######    ##      ####
##      ##        ##    ##    ##
######  ##  ######  ########  ##
##      ##  ##          ##    ##
####  ######    ##  ##      ####
##    ##########    ######    ##
##  ##  ####      ##      ##  ##
##  ##        ####    ####    ##
##  ##  ##  ##      ######  ####
##  ####    ##  ##    ##      ##
##        ##      ##      ##    
################################
