################################
    ##    ##      ##  ##      ##
##      ##    ####        ##  ##
##  ##      ##  ##  ####    ####
####    ######        ####    ##
##    ##        ######      ####
####  ##  ##  ##        ##    ##
##    ##    ################  ##
##  ######    ##        ##    ##
##    ######  ##  ####    ##  ##
####    ##    ##    ####    ####
##  ##      ##  ##    ####    ##
##      ####      ##      ##  ##
##  ######    ##  ##########  ##
##          ##                  
################################
