################################
          ##        ##        ##
##  ####    ##  ####    ####  ##
##      ####      ##  ##  ##  ##
######    ##  ##          ##  ##
##    ##    ##    ######  ##  ##
##  ##  ##  ##  ##        ##  ##
##  ##      ##  ######  ##    ##
##      ####  ##      ######  ##
##  ####          ##  ######  ##
##        ##########    ##    ##
############        ##  ##  ####
##            ######        ####
##  ######  ##      ##  ##    ##
##      ##      ##        ##    
################################
