################################
              ##              ##
####  ####  ##    ##  ####  ####
##        ##    ######      ####
##  ##  ##    ##  ##    ####  ##
##    ####  ####  ##  ##      ##
####  ##          ##  ##  ##  ##
####      ##  ######    ##    ##
##    ########      ##  ##  ####
##  ##    ##    ##  ##  ##    ##
##      ##  ######        ##  ##
##  ####          ########    ##
##        ####  ##          ####
############        ##  ##    ##
##            ##  ##      ##    
################################
