################################
                            ####
##  ####  ######  ########    ##
##  ##  ##      ##      ####  ##
##  ##  ##  ##      ##        ##
##  ##  ##    ######  ##########
##  ##      ##                ##
##  ##  ####    ########  ##  ##
##    ##      ##        ####  ##
##  ##    ####  ##  ##  ##    ##
##  ##  ##      ##  ##      ####
##  ##  ##  ##  ##    ####    ##
##      ######    ##  ##  ##  ##
##  ####        ##    ##  ##  ##
##        ####    ##  ##        
################################
