################################
      ##                ##  ####
####      ####  ##  ####      ##
######  ####      ##      ##  ##
######  ##    ######  ######  ##
####      ######      ##      ##
##    ####        ######  ######
##  ##  ##  ########      ##  ##
##  ##      ##        ####    ##
##      ##  ##  ######      ####
##  ##    ####  ##    ##  ##  ##
####  ##      ##  ##          ##
##    ######        ########  ##
##  ##      ##  ####      ##  ##
##      ##            ##        
################################
