################################
              ##          ##  ##
####  ####  ##    ##  ##      ##
##    ##      ####    ######  ##
##  ##    ##        ##        ##
##  ##  ##  ########  ##  ##  ##
##  ##  ##            ##    ####
##  ##    ##########    ##    ##
##  ####  ##        ##    ##  ##
##    ##  ##  ####    ##      ##
##  ##          ##  ##  ##  ####
####  ########  ##        ##  ##
####          ##  ##  ##      ##
##  ####  ##        ##  ####  ##
##          ##  ##              
################################
