################################
    ##  ##        ##    ##    ##
##          ####    ##      ####
##  ####  ##  ##  ##    ##  ####
##  ##    ##        ##  ##    ##
####    ##  ####  ##      ##  ##
##    ##    ##    ####  ####  ##
##  ##  ##  ####        ##    ##
##      ##      ##  ####  ##  ##
##  ##  ######    ##      ##  ##
##  ##        ##  ##  ##  ##  ##
##    ##  ##  ##  ##    ##    ##
####  ##    ##    ####  ##  ####
####  ##  ##    ##  ##  ##  ####
##    ##      ##                
################################
