################################
    ##          ##  ##        ##
##    ####  ##      ##  ####  ##
####      ##  ##  ##    ##    ##
##    ##      ##      ##    ####
####    ####    ####  ##  ##  ##
##    ##      ##    ##        ##
##  ##  ####  ##  ####  ##  ####
##  ##    ##      ##    ##    ##
##    ##    ######    ##    ####
####    ##      ##########    ##
##  ##  ##  ##        ######  ##
##        ##  ##  ##    ##    ##
##  ######        ####      ####
##          ##  ##      ##      
################################
