################################
              ##  ##      ##  ##
##  ######  ##        ####    ##
##  ##          ##  ####    ####
##  ##  ##########        ######
##    ##          ##  ##    ####
##  ##    ######    ##  ##    ##
##    ##  ##    ##  ##  ##  ####
##  ##    ##  ##    ##  ##    ##
##    ##  ##  ##  ####      ####
####  ##  ##      ##    ####  ##
####  ##    ##  ##  ##    ##  ##
##      ####    ##  ####  ##  ##
##  ####  ##  ##      ##  ##  ##
##            ##  ##            
################################
