################################
        ##        ##      ##  ##
##  ##    ##  ##      ##      ##
##    ####    ########  ##  ####
####  ####  ##          ##    ##
##          ##  ####  ##    ####
####  ######        ##    ##  ##
##    ##  ##  ##  ##    ##    ##
##  ##    ##  ##    ##  ##  ####
##    ##  ##  ####    ##      ##
####  ##        ####      ##  ##
##    ########      ##  ##    ##
##  ##      ####  ##    ##  ####
##  ##  ##      ##    ##      ##
##      ##  ##      ##    ##    
################################
