################################
            ##  ##            ##
##  ####  ##      ##  ##  ######
##    ##      ##    ##        ##
####    ######  ##  ##  ####  ##
####  ##        ##  ####      ##
##    ##  ####    ##      ##  ##
##  ##    ######  ##  ##  ##  ##
##    ##    ##    ####    ##  ##
####    ##  ##  ##  ##  ####  ##
##  ##  ##  ##          ##    ##
##      ##  ######  ##    ##  ##
##  ####        ##    ##    ####
##  ##  ######    ##    ##    ##
##              ######    ##    
################################
