################################
        ##            ##      ##
######      ####  ####    ##  ##
##      ####            ########
##  ####    ##  ##  ####  ##  ##
##  ######        ##      ##  ##
##    ##    ######    ##  ##  ##
####    ####        ##    ##  ##
##  ##    ##  ######  ##      ##
##    ##      ##  ##    ########
##  ##    ####        ##      ##
##  ##  ####    ####  ##  ##  ##
##      ##    ##      ######  ##
##  ######  ##    ##          ##
##          ##  ##    ##  ##    
################################
