################################
          ##                  ##
##  ##  ##    ######  ##  ######
##  ##  ##  ##      ##        ##
##  ##  ##  ##  ##    ######  ##
##  ####          ##      ##  ##
##      ##  ######  ####  ##  ##
##  ##    ##        ##    ##  ##
##  ####    ##  ####    ##    ##
##      ##            ##    ####
##  ##    ##  ########  ##    ##
####  ##    ##              ####
##    ##  ##    ####  ####    ##
##  ##  ##    ##    ##  ##  ####
##          ######              
################################
