################################
          ####        ####    ##
##  ######    ##  ##        ####
##          ##  ##    ##  ##  ##
##  ##  ####      ####        ##
##    ##      ##        ####  ##
##  ##    ##  ##  ####  ##    ##
##    ##  ##  ####    ##    ####
####  ##  ##      ##      ##  ##
##      ##  ####  ####  ##    ##
##  ##        ##      ##  ##  ##
##    ######  ##  ##      ##  ##
##  ##        ##  ##  ##  ##  ##
####    ##  ##  ##    ##  ##  ##
##    ##            ##          
################################
