################################
        ##    ##      ##      ##
##  ##  ##  ##    ##      ##  ##
##  ##      ##  ##    ####    ##
##    ####  ##  ##  ##    ######
####      ##    ##      ##    ##
####  ####    ##    ##    ##  ##
##    ##    ##  ##    ##  ##  ##
##  ##    ##      ##    ##    ##
##  ##  ##  ##  ##  ##  ##  ####
##  ##      ##  ##  ##      ####
##    ####  ##        ####    ##
##  ##      ####  ##      ##  ##
##  ##  ####      ##  ##    ####
##            ####      ##      
################################
