################################
      ##      ##      ######  ##
##  ##    ####    ##    ##    ##
##      ##      ######      ####
##  ##    ####  ####  ##  ##  ##
##  ##  ##            ##  ##  ##
##    ##    ####  ####    ##  ##
####    ##  ##  ##      ##    ##
##    ####      ##  ####  ##  ##
####      ####  ####          ##
##    ##    ##    ##  ##  ######
##  ##  ##    ##  ####        ##
##  ##  ##  ##        ######  ##
##  ##  ##    ######      ##  ##
##        ##          ##        
################################
