################################
      ##              ######  ##
####      ##########    ##    ##
##    ##            ##      ####
##  ##    ######  ##    ####  ##
##  ##  ##      ##    ##      ##
##    ####  ##  ##  ##    ##  ##
######      ##  ##      ##    ##
##      ##  ##    ##  ####  ####
##  ####  ##  ##  ##  ##      ##
##    ##      ##  ####    ##  ##
##  ##    ##  ##    ##  ##    ##
####    ##  ##    ##    ##  ####
##  ##        ##  ##  ####  ####
##      ####          ##        
################################
