################################
        ##  ##  ####      ######
##  ##                ##    ####
##    ##########  ########    ##
####  ##      ##      ##  ######
##    ######    ####          ##
##  ##        ##  ####  ####  ##
##  ####  ##  ##      ####    ##
##    ##  ##    ##  ##      ####
####      ##  ##    ##  ##    ##
##  ########  ####  ##    ##  ##
##  ##                ##  ##  ##
##      ##  ##########    ##  ##
####  ##  ##            ####  ##
##        ##  ##  ##  ##        
################################
