################################
              ##      ##      ##
####  ######      ##  ##  ##  ##
##    ##    ##  ##    ##  ##  ##
##  ####  ##      ##    ##    ##
####      ##  ##    ##      ####
####  ####    ####  ##  ##    ##
##    ##    ##      ##    ##  ##
##  ##  ####    ########    ####
##  ##        ##    ##  ##    ##
##  ##  ######  ##      ##  ####
##      ##      ####  ####    ##
########    ####          ##  ##
##        ##  ##  ####  ####  ##
##  ####            ##          
################################
