################################
          ##                  ##
##  ####  ##  ##########  ##  ##
##  ##    ##  ##      ##  ##  ##
##    ##  ##  ######  ##    ####
##  ##    ##      ##    ##    ##
##    ##      ####  ##    ##  ##
####    ######        ##  ##  ##
##  ##  ##      ####  ##  ##  ##
##      ####  ####    ##      ##
##  ####          ##    ####  ##
##  ####  ##  ##    ##      ####
##      ##  ######    ####    ##
##  ##        ##    ##      ####
##    ##  ##      ##    ##      
################################
