################################
        ##            ####    ##
##  ##    ##  ##  ##      ##  ##
##    ######  ##  ######      ##
####          ##        ####  ##
##    ##  ####  ##  ##      ####
####    ##      ####  ####    ##
##  ##  ##  ##            ##  ##
##          ####  ##  ######  ##
####  ##  ##  ##  ####        ##
##    ####          ##  ####  ##
##  ##    ##  ##  ####  ##    ##
##    ##    ######      ##  ####
####  ####    ##    ######  ####
##        ##      ##            
################################
