################################
                  ##          ##
##  ######  ##  ##  ##  ####  ##
##  ##  ##    ##    ##  ####  ##
##        ##  ##  ##  ##      ##
##  ####  ##      ##      ##  ##
##    ####  ######    ##    ####
####            ##  ######    ##
##  ######  ##    ##  ##  ##  ##
##  ##    ##    ##            ##
##      ##    ##    ########  ##
####  ##    ##    ##      ##  ##
##    ####      ##    ##      ##
####      ######  ##  ##########
##    ##                        
################################
