################################
          ##        ##        ##
######  ##    ####    ##  ##  ##
##          ##  ####  ##  ##  ##
##  ##  ####          ##  ##  ##
##  ##    ##########    ##    ##
##  ##  ##          ##    ##  ##
##  ####    ######    ##  ##  ##
##        ##        ##        ##
##########    ########  ####  ##
##          ##        ##      ##
##  ########    ####  ##  ##  ##
##  ##        ##    ####  ##  ##
##  ##  ######  ##  ##      ####
##      ##              ##      
################################
