################################
    ##  ##      ##  ##        ##
##          ##        ####  ####
######  ##    ######          ##
##      ##  ##      ####  ##  ##
##  ##    ##    ##  ######    ##
##    ######  ####    ##    ####
####              ##    ##  ####
##    ##  ##  ##    ##  ##    ##
##  ##  ##      ####    ##  ####
####      ######      ##      ##
##  ####          ####  ##  ####
##      ##########      ##    ##
####  ####      ##  ##  ####  ##
##          ##      ##          
################################
