################################
    ####                ##    ##
##        ######  ####      ####
##  ##  ##    ##  ##    ##    ##
##  ##      ##    ######  ##  ##
##    ##########            ####
##  ##      ##  ####  ####    ##
######  ##          ##      ####
##        ########      ##    ##
##  ##  ##        ##  ##  ##  ##
##  ##  ##  ####    ##      ####
##  ####    ######      ##    ##
##        ##  ##  ##  ##    ####
##  ########  ##    ####  ##  ##
##              ##              
################################
