################################
        ##  ##      ##        ##
##  ##  ##      ##    ####  ####
##  ##    ##  ##  ##    ##  ####
##    ##      ##    ##  ##    ##
####    ######  ##  ##    ##  ##
##  ##  ##  ##      ####      ##
##  ##  ##      ##      ####  ##
##      ##  ##########    ##  ##
####  ####      ##    ##      ##
####  ##    ##    ##    ########
##    ####  ##  ######        ##
##  ##    ##      ##    ##  ####
##      ##    ##      ##      ##
##  ####    ######  ##    ##    
################################
