################################
    ##    ##      ##          ##
##      ##    ##  ##  ####  ####
####  ####  ####  ##    ##    ##
##    ##    ##      ##    ##  ##
##  ##    ####  ##    ##    ####
##    ##  ##    ##########    ##
##  ##    ##  ##      ##    ####
##    ##  ##      ##  ##  ##  ##
####      ##  ####    ##  ##  ##
##    ##    ####    ##    ##  ##
####    ####      ##    ##    ##
##  ##    ##  ##    ##    ##  ##
##  ##  ##    ######  ##      ##
##        ##              ##    
################################
