################################
            ##      ##        ##
##  ######  ##  ##      ####  ##
##  ##  ##  ####    ####      ##
##  ##            ##      ######
##    ##  ####  ##    ####    ##
####  ##  ##      ##    ####  ##
##    ####    ####  ##    ##  ##
##  ##      ##  ##    ##  ##  ##
##    ########  ##  ####      ##
####            ##      ####  ##
##    ####  ##    ####      ####
####  ##    ######    ####    ##
##      ##        ##  ##  ##  ##
##  ##    ##  ##                
################################
