################################
            ##  ######  ##    ##
##  ##  ##        ##      ##  ##
##    ##  ##  ##      ##      ##
####  ##  ##    ##  ##  ####  ##
##    ##    ####    ##  ##    ##
##  ##  ##    ##  ####    ##  ##
##        ##  ##      ##      ##
########      ##  ##    ##  ####
##      ##  ##      ##  ##    ##
##  ##    ##    ####    ####  ##
##    ##    ####    ##    ######
##  ######        ##  ##      ##
##    ##  ########      ####  ##
####                ##          
################################
