################################
    ##        ##        ##    ##
##  ##  ####      ##  ##    ####
##  ##      ######        ##  ##
##  ##  ##      ##  ####  ##  ##
##    ####  ##  ##      ##    ##
####          ########  ##  ####
##    ######    ##      ##    ##
##  ##      ##  ##  ##    ##  ##
##  ##  ##    ##      ##  ##  ##
##  ##  ####      ##  ######  ##
##  ##    ############        ##
##    ##          ##    ########
##  ##  ########  ##  ##      ##
##            ##          ##    
################################
