################################
        ##      ####    ####  ##
##  ##      ##      ##        ##
##    ######  ####    ####  ####
####          ##  ##  ##      ##
##    ######        ##    ##  ##
##  ##      ######  ##  ##  ####
####    ##      ##  ##        ##
##    ##    ####      ######  ##
##  ##    ####    ####        ##
##    ##  ##    ##      ####  ##
####  ##      ##    ####      ##
####  ##  ######  ##  ##  ######
##      ##        ##  ##  ##  ##
##  ##      ##  ##              
################################
