################################
        ####                  ##
##  ##      ##  ####  ######  ##
##    ####      ##  ##      ####
####      ##  ##        ##    ##
######  ######    ##  ####  ####
####    ####    ##    ##    ####
##    ##      ##    ##    ##  ##
##  ##    ##  ##  ##    ##    ##
##  ##  ##      ##    ##    ####
##      ##  ######  ##  ##    ##
##  ####  ##        ##    ##  ##
##  ##    ##  ##  ####  ##    ##
##  ##  ##  ##  ##        ##  ##
##                  ####        
################################
