################################
    ##      ####        ##  ####
##    ####        ####  ##    ##
####        ######    ##  ##  ##
##    ##  ##        ##        ##
##  ##  ##    ####    ####  ####
##  ##      ##    ##        ####
##      ####    ##  ######    ##
##########    ##        ####  ##
##          ##    ####    ##  ##
##  ##  ##      ##  ##  ##    ##
##  ##    ##  ##      ##    ####
##    ##    ####  ##    ##    ##
##  ##    ##        ##    ##  ##
##    ##      ####    ##        
################################
