################################
        ##            ####    ##
##  ##  ##  ##  ####        ####
##  ##  ##  ##      ######    ##
##    ##      ####        ##  ##
####  ##  ##      ####  ##    ##
##      ##    ####  ##  ####  ##
##  ##  ##  ##  ##  ##      ####
##  ##          ##  ##  ##    ##
##    ##  ######    ####  ##  ##
####    ##        ##          ##
##    ##    ##  ##    ######  ##
##  ##  ##    ######  ##  ##  ##
##        ##    ##    ##  ##  ##
####  ##    ##      ##          
################################
