################################
        ##  ##        ##      ##
##  ##          ##  ##    ##  ##
##    ######  ##        ##    ##
##  ##      ##  ##########  ####
##  ##  ##  ##                ##
##  ##  ##  ##  ##  ####  ##  ##
######  ##      ####    ####  ##
##      ####  ##      ##      ##
##  ####      ##  ####    ######
##      ##  ####  ##    ##    ##
##  ##    ##      ##  ##    ####
####    ##    ####      ##    ##
##    ##    ##  ##  ##    ##  ##
####      ##          ##        
################################
