################################
                ##          ####
##  ######  ##  ##  ##  ##    ##
##  ##  ##  ##  ##  ##    ##  ##
##      ##    ##      ##  ##  ##
##  ##    ##    ####  ##    ####
####    ##  ##          ##    ##
##    ##      ##  ######  ##  ##
####      ##  ##          ##  ##
##  ########    ##  ######    ##
##          ##    ##        ####
##  ######  ####  ##  ####  ####
##      ####      ##    ##    ##
##  ##    ##  ####  ##    ##  ##
##    ##              ##  ##    
################################
