################################
    ########      ##          ##
##    ####    ##    ##  ##  ####
####        ##  ##    ##      ##
##    ##  ##      ##    ####  ##
##  ##    ##  ##    ##    ##  ##
####    ##      ####  ##      ##
##    ##    ##          ########
##  ##    ##    ##  ##  ##    ##
##  ##  ####  ##    ##  ##  ####
##    ##      ##  ####      ####
####    ########  ##  ####    ##
##  ##            ##    ##  ####
##    ############  ##        ##
####                    ####    
################################
