################################
        ##  ##      ##      ####
##  ##  ##      ##    ####    ##
##  ##    ##  ##  ##      ##  ##
##    ####    ##    ####  ##  ##
####        ##    ##      ##  ##
##  ########    ##    ######  ##
##  ##      ##      ##        ##
##      ##    ##  ##  ##  ##  ##
##  ##    ####    ##  ##  ##  ##
##    ##    ##  ##        ##  ##
####    ##  ##    ##  ######  ##
##  ##    ##  ##  ##  ##      ##
##    ##              ####  ####
####      ##  ####  ##          
################################
