################################
    ##              ####  ##  ##
##    ####  ##  ##            ##
####      ##      ####  ####  ##
##  ####    ##  ######  ##    ##
##  ##  ##  ##    ##    ####  ##
##      ##  ##  ##    ##      ##
####  ##    ##    ##    ########
####      ##    ##    ##      ##
##    ####  ##  ##  ####  ##  ##
####          ####        ##  ##
##  ####  ##  ##    ######    ##
##    ##  ##  ######        ####
####    ##          ##  ##    ##
######      ##  ##        ##    
################################
