################################
      ##                      ##
##  ##    ####  ####  ####  ####
##    ##      ##  ##  ##      ##
####    ####      ##  ##  ##  ##
##    ##      ######  ##    ####
##  ##  ##  ##        ####    ##
##        ##    ##  ##  ####  ##
########      ######      ##  ##
##      ######  ##    ##      ##
##  ##          ##  ##  ####  ##
##    ####  ####    ##      ####
##  ##  ##      ##    ####    ##
##        ####    ##      ##  ##
####  ##      ##      ##        
################################
