################################
          ##            ##    ##
########      ##  ####  ##  ####
##      ##  ##    ##    ##    ##
##  ##    ######  ##  ##  ##  ##
##  ####    ##    ##          ##
##    ####      ##  ########  ##
####      ##  ##          ##  ##
##  ####  ##    ########  ##  ##
##          ####      ##      ##
##  ####  ##  ##  ##    ####  ##
##  ##    ##      ####      ####
##  ##  ######  ##  ##  ##    ##
##    ##  ##  ##      ####  ####
####              ##            
################################
