################################
                ##  ##  ##    ##
######  ##  ##              ####
##        ##  ######  ####    ##
##  ##  ##    ##    ##  ##  ####
##  ##  ##  ##  ##      ##    ##
##    ####  ##  ####  ##  ##  ##
####  ##    ##            ##  ##
####    ##    ##  ####  ####  ##
##  ##    ##  ##      ##      ##
##    ##  ##    ##  ##    ######
##  ##      ##  ##      ##    ##
##    ####      ##  ##  ##  ####
####      ######      ##      ##
##    ##          ##      ##    
################################
