################################
      ##  ##      ##      ##  ##
##  ##      ##  ####  ##      ##
##  ##  ##            ##  ##  ##
##  ##  ####  ######  ##  ######
##  ##      ##      ##        ##
##    ####      ##    ######  ##
##  ##    ######    ##        ##
##  ####  ##  ##  ##    ########
##    ##      ##  ##  ##      ##
####      ##      ##    ##  ####
##    ####  ######    ##      ##
##  ##  ##        ####    ##  ##
##        ######        ####  ##
####  ##          ##  ##        
################################
