################################
      ##  ####  ##            ##
####              ######  ##  ##
##    ####  ####          ##  ##
##  ##  ##      ######  ####  ##
##      ##  ##      ####      ##
##  ##    ##  ####      ########
##  ######      ##  ##        ##
####        ##    ####  ####  ##
##    ####    ##  ##      ##  ##
####      ####    ##  ####    ##
##    ##      ##  ##  ####  ####
##  ##    ##  ##  ####        ##
####    ##    ##        ##  ####
##    ##    ##    ##  ##        
################################
