################################
          ##          ##      ##
######  ##    ######      ##  ##
##      ##  ##      ####    ####
##  ####    ##  ##  ######    ##
##  ######  ##  ##    ######  ##
##    ##    ##    ##    ##    ##
####    ##  ####    ##  ####  ##
##    ####      ##  ##      ####
##  ##      ##        ####    ##
##    ##  ##    ########  ##  ##
####    ####  ##              ##
##  ##      ##  ##  ##  ####  ##
##  ######  ##  ##    ##      ##
##                  ##    ##    
################################
