################################
                ##            ##
##  ##########    ##  ##########
##  ##        ####            ##
##  ####  ##        ##  ####  ##
##      ######  ########      ##
######    ##        ##    ##  ##
##  ##  ##    ####  ##  ####  ##
##  ##    ####      ##  ##    ##
##  ####  ##    ##  ##  ##  ####
##        ##  ######    ##  ####
##  ##  ##    ######  ##      ##
##  ####  ##    ##    ####  ####
##          ######  ##        ##
##  ##  ##          ##  ####    
################################
