################################
      ##  ##        ##      ####
####          ####      ##    ##
##    ####  ########  ######  ##
##  ##    ##########    ##    ##
##  ####    ######    ##    ####
##      ##    ##    ##  ##  ####
######  ####  ##  ##    ##    ##
##            ##    ##      ####
##  ######  ##    ##    ####  ##
####      ####  ####  ##      ##
##    ##        ##      ##  ####
####    ############  ##      ##
##    ##        ##      ####  ##
##  ##    ####      ##          
################################
