################################
                  ##          ##
########  ##  ##    ##  ##  ####
##        ####  ##      ##    ##
##  ##  ##        ##########  ##
##    ##    ##  ##      ##    ##
####      ##    ##  ##  ##  ####
##  ######    ##    ##  ##    ##
##        ##    ##  ##  ####  ##
##  ####      ##    ##        ##
##    ##  ####    ##  ##  ##  ##
##  ##      ######      ##    ##
##    ######      ####  ##  ####
##  ##        ##  ##    ##  ####
##      ##  ##        ##        
################################
