################################
        ##      ##            ##
##  ##      ##    ######  ##  ##
##    ##  ##  ##      ##  ######
####    ##      ######        ##
##  ##  ##  ##          ####  ##
##  ##  ##    ##########      ##
##  ##    ####          ####  ##
##  ##  ##      ######    ##  ##
##      ##  ####    ####      ##
##  ####    ##  ##      ####  ##
##  ##    ##        ##        ##
##    ##  ##  ######  ##########
##  ####  ##      ##          ##
##        ##  ##      ##  ##    
################################
