################################
        ##      ##            ##
##  ##  ##  ####  ####  ####  ##
##  ##  ##  ##      ##  ##    ##
##    ####  ##  ##        ##  ##
####        ##    ##  ##  ##  ##
##    ##  ##  ##    ##    ##  ##
####    ####    ##    ##    ####
##  ##        ##    ##  ##    ##
##    ######  ##  ##      ##  ##
##  ##    ##    ####  ##  ##  ##
##      ######  ##    ##  ##  ##
##  ##    ####      ####      ##
##  ####      ##  ##    ####  ##
##      ####        ##          
################################
