################################
                    ##  ##    ##
##  ##  ####  ##  ##      ##  ##
####    ##    ##      ##      ##
##    ##    ##    ########  ####
##  ####  ##  ####    ##      ##
##  ##    ##      ##    ####  ##
##  ##  ####  ##    ##        ##
##  ##      ######    ##  ##  ##
##  ####  ##  ##  ##    ####  ##
##    ##            ##      ####
####    ####  ##  ##  ####    ##
####  ##      ####        ##  ##
##      ####    ##  ####  ##  ##
##  ##      ##        ##        
################################
