################################
      ##      ##      ##      ##
####      ##      ##      ##  ##
##    ####  ######    ##    ####
##  ####        ####    ##    ##
##  ##    ####      ##  ####  ##
##  ##  ##    ####  ####  ##  ##
##  ##    ##    ##        ##  ##
##    ##      ########  ##    ##
##  ##  ####  ####    ##    ####
##        ##      ##  ##  ######
##  ######  ####  ##  ##    ####
##  ##      ##    ##    ##    ##
##      ##      ##  ##  ##  ####
##  ##    ##  ##                
################################
