################################
    ##  ##    ##    ##        ##
##  ##      ##    ####  ##  ####
##  ######  ##  ##      ##    ##
##      ##  ##      ####  ##  ##
####  ##    ##  ####      ##  ##
####      ##    ##    ##  ##  ##
##    ####    ##    ##    ##  ##
##  ##  ##  ##  ##    ##      ##
##  ##          ####    ####  ##
##  ##  ########      ##  ##  ##
##  ####      ##  ####    ##  ##
##        ##  ##  ##  ##  ##  ##
##########        ##  ##      ##
##          ##  ##        ##    
################################
