################################
              ##        ##    ##
##  ########    ##  ##      ####
##  ##        ##      ####    ##
##    ##  ##  ##  ##  ######  ##
####    ##    ####      ##    ##
##  ##    ##      ####  ##  ####
##    ##    ####  ##    ##    ##
##  ##  ##    ##      ######  ##
##        ##    ######  ##    ##
##  ##  ##  ##      ##    ##  ##
##    ##      ####    ##  ##  ##
####      ##        ####  ##  ##
##    ##    ##  ####      ##  ##
##  ######  ##        ####      
################################
