################################
                          ##  ##
##########  ##########  ##    ##
##          ##      ##      ####
##  ########  ####    ####    ##
##  ##    ##      ##      ##  ##
##    ##  ##  ##      ##  ##  ##
####      ##    ####  ##  ##  ##
##  ##  ##  ##  ##      ####  ##
##    ##          ######      ##
####      ######      ##  ######
##    ####      ####  ##  ##  ##
####        ##    ##  ##      ##
##  ##########  ####    ####  ##
##                  ##          
################################
