################################
              ####    ##      ##
####  ######      ##      ##  ##
##  ##      ####  ##  ##  ##  ##
##  ##  ##  ##    ##  ##  ##  ##
##        ##    ##    ##  ##  ##
##  ########  ##    ##    ##  ##
##  ##        ######    ##    ##
##  ##  ######      ##    ##  ##
##      ##  ##  ##      ##    ##
##  ####        ####  ##    ####
##      ####  ##    ##  ##  ####
######  ##      ##      ##    ##
##  ##  ######  ##  ####  ##  ##
##              ##              
################################
