################################
            ##  ##          ####
##  ####  ##        ##  ##    ##
##    ######  ##  ##    ####  ##
####          ####    ##  ##  ##
####  ##  ####      ##        ##
##      ##      ####    ########
##  ##    ##  ####  ##        ##
##  ####  ##  ##      ######  ##
##      ##    ##  ####        ##
####  ##    ##          ########
####  ##  ##  ##########      ##
##    ##  ##              ##  ##
##  ##    ##  ############    ##
##    ##                  ##    
################################
