################################
      ##  ##                  ##
##  ##        ##  ##########  ##
##  ##  ######    ##          ##
##  ##  ##      ##  ####  ######
##      ##  ######        ##  ##
##  ######        ##  ##  ##  ##
##        ######    ##    ##  ##
######  ##    ##  ##    ##    ##
##      ##  ####    ##      ####
##  ######      ##    ##########
##  ##      ##  ####        ####
##  ##  ######      ########  ##
##      ##      ####      ##  ##
####  ##    ##        ##        
################################
