################################
        ##      ####          ##
##  ##  ##  ##      ########  ##
##  ##  ##    ########        ##
####    ##  ##          ####  ##
##    ####    ####  ####  ##  ##
####      ##  ##      ##      ##
##  ##  ##    ##  ####    ######
##  ##    ##  ##      ##      ##
##      ##    ##  ##    ####  ##
##  ######  ##  ##    ##      ##
##  ##      ##  ##  ##  ####  ##
##  ##  ####        ##        ##
##  ##  ##    ######    ##  ####
##          ##        ##        
################################
