################################
            ##                ##
##  ######  ##  ##########  ####
##        ##    ##      ##    ##
####  ##    ##    ##  ####  ####
##      ##      ##        ##  ##
##  ##    ##  ##  ####  ##    ##
##  ##  ##  ##              ####
####    ##  ##  ##  ######  ####
##    ##        ##  ##        ##
##  ##    ####  ##    ######  ##
##    ##      ##    ##      ####
####    ####    ##      ##    ##
######    ######  ######  ##  ##
########                        
################################
