################################
      ##          ##    ##    ##
##  ##    ##  ##  ####      ####
##      ##    ##      ##  ######
####  ##  ##    ####  ##    ####
##        ##  ##        ##    ##
##  ####  ##    ##  ##    ##  ##
####        ##  ####  ##  ##  ##
##    ######          ##      ##
##  ##      ##  ####  ######  ##
##    ####    ######      ##  ##
####  ######    ##    ##    ####
####    ##  ##    ##    ##    ##
##  ##  ##    ##    ####  ##  ##
##          ######              
################################
