################################
    ##      ##  ##            ##
##      ##  ##      ########  ##
##  ####    ####  ##          ##
##  ##    ##      ##  ######  ##
##    ##    ########  ##      ##
####  ####            ######  ##
##      ######  ######      ####
##  ##      ####        ##    ##
####  ####        ##  ##  ##  ##
##        ####  ##        ##  ##
##  ####      ##  ########    ##
##    ######  ##          ##  ##
####        ##    ######  ##  ##
######  ##      ##              
################################
