################################
    ##  ######          ##  ####
##        ##    ####  ##      ##
##  ####      ##      ##  ##  ##
##  ######  ####  ##  ##  ##  ##
##    ##  ##      ####    ##  ##
####  ##    ##  ##      ##    ##
####    ##  ##      ####  ##  ##
##  ##        ######      ##  ##
##      ##  ##        ##      ##
########  ##    ######  ####  ##
##        ##  ##        ##    ##
##  ####      ####  ##  ##  ####
####  ########        ##      ##
##              ####      ##    
################################
