################################
    ##          ##            ##
##  ##  ####  ##    ####  ##  ##
##  ##    ##    ####    ####  ##
##    ##    ##    ##  ##      ##
##  ##  ##    ##      ##  ##  ##
##        ##    ######    ##  ##
##  ####    ##  ##    ##  ##  ##
##      ######    ##      ##  ##
##  ##  ##      ##    ##    ####
##  ##  ##  ####  ##    ##    ##
##  ##  ##  ##      ##  ##  ####
##  ##      ##  ##    ##      ##
##    ########  ##  ##    ##  ##
####            ##      ##      
################################
