################################
            ####  ##          ##
##  ####  ##      ##  ##  ##  ##
##  ##    ##  ########    ##  ##
##  ##  ##    ##  ##    ##    ##
####    ##  ##      ##  ##  ####
####  ##    ##  ##      ##    ##
##    ##  ##      ##########  ##
##  ####    ####        ####  ##
##  ##  ##  ##  ####  ##      ##
##      ##        ####    ##  ##
##  ##    ######        ####  ##
##  ######      ####  ####    ##
##      ##  ##      ##      ####
##  ##        ####      ##      
################################
