################################
    ##              ##        ##
##    ####  ######      ####  ##
####            ######    ##  ##
##    ######  ##      ####    ##
####        ##    ##    ##  ####
##  ####  ####  ##    ##    ####
##    ##      ##    ##    ##  ##
####    ####    ##      ##    ##
##    ####    ##  ##  ##    ####
##  ##      ##      ##    ##  ##
##      ######  ##    ##      ##
##  ####          ##    ####  ##
##  ##    ####  ##  ##        ##
##      ##            ##  ##    
################################
