################################
    ##        ##      ####    ##
##      ##  ##    ##      ##  ##
##  ##    ##    ##  ####      ##
##  ####    ##      ##    ##  ##
##      ##    ##  ######    ####
####  ##  ##    ##  ##  ##    ##
##    ##    ##            ##  ##
####    ##    ##  ########    ##
##  ##  ####  ##          ##  ##
##  ##          ########  ##  ##
##    ####  ##  ##        ##  ##
####  ##  ##    ##  ##  ##    ##
####      ##  ####    ####  ####
##    ##          ##            
################################
