################################
    ##            ##    ##    ##
##    ##  ######    ##    ##  ##
####      ##      ##  ##  ##  ##
######  ##    ##      ##      ##
####    ##  ##  ####  ##  ##  ##
##    ##          ##    ##    ##
##  ##    ######    ####    ####
##    ####      ##    ##  ##  ##
######      ##      ##    ##  ##
##      ######  ##    ##      ##
##  ####          ####  ##  ####
##      ##########      ##    ##
##  ##              ##    ##  ##
##    ##  ##  ##  ######        
################################
