################################
    ##            ##        ####
##    ########  ##    ####    ##
####        ##      ##    ##  ##
##  ######    ##  ####  ##    ##
##        ##  ##  ##        ####
##  ##  ####    ##    ####    ##
##  ##      ##  ####      ##  ##
##    ####  ##      ####  ##  ##
####    ##    ####    ##  ##  ##
##    ##  ##      ##  ##  ######
##  ####    ####      ##      ##
##  ##    ####  ##  ##    ##  ##
##      ####      ##  ######  ##
##  ##        ##                
################################
