################################
        ######  ##          ####
##  ##    ##        ######    ##
##  ####  ##  ######      ##  ##
##    ##  ##      ##  ##  ##  ##
####  ##    ####  ##  ####    ##
####    ##        ##    ##  ####
##    ##    ##  ######      ####
##  ##    ######  ##    ####  ##
##  ####    ##    ##  ##      ##
##      ####    ####  ##  ##  ##
######  ##    ##      ##  ##  ##
##      ##  ######  ##    ##  ##
##  ####      ##      ##  ##  ##
####      ##      ##      ##    
################################
