################################
                    ##  ##    ##
##  ##  ##  ########    ##  ####
##  ##    ##        ##  ##    ##
##    ##  ##  ####      ####  ##
##  ##  ##    ##########      ##
##      ##  ##  ##        ##  ##
####  ##    ##      ####    ####
##        ##  ##  ##    ##    ##
##  ####  ##      ##  ##  ##  ##
##  ##      ##  ##        ##  ##
####    ####    ####  ####    ##
##    ##      ##  ##    ##  ####
####  ####  ##        ##      ##
##          ##  ####      ##    
################################
