################################
      ##        ##            ##
##  ##    ####    ####  ####  ##
##    ##    ####        ##    ##
##  ##  ##      ##  ####    ####
##      ######    ##    ##    ##
####  ##      ##    ##  ##  ####
####      ##    ##  ##  ##  ####
##    ####    ####      ##    ##
####  ##    ##      ####  ##  ##
##      ##  ##  ##        ##  ##
##  ##  ##        ########    ##
##    ##    ##  ##          ####
####    ####  ##    ######  ####
######    ##      ##            
################################
