################################
      ##  ##          ####    ##
##  ##        ##  ##        ####
##      ##  ####  ########    ##
####  ####      ##        ##  ##
##        ####      ####    ####
##  ##  ##    ##  ####  ##    ##
##    ##    ##  ##          ####
##  ##    ##        ######    ##
##  ##  ##    ##  ##    ####  ##
####    ########    ##        ##
##    ##        ##  ##  ##  ####
####  ##  ####      ##    ##  ##
##        ##  ######  ##  ##  ##
##  ##  ##                      
################################
