################################
          ##                  ##
##  ####    ####  ##  ##########
##      ####      ##          ##
##  ##  ##    ##  ####  ####  ##
##  ##      ##        ####    ##
##    ####    ########      ####
####      ####          ##    ##
##  ##  ##      ####  ##  ##  ##
##    ##    ####    ##        ##
####      ##      ##    ########
##  ##  ##    ######  ##      ##
##    ##    ####          ##  ##
####      ####    ##  ##    ####
##    ##        ##      ##      
################################
