################################
          ####  ##            ##
##  ####          ##  ######  ##
##      ####  ##      ##      ##
######    ##  ########  ####  ##
##    ##  ##                ####
####  ##    ##############  ####
##      ##  ##          ##    ##
##  ##  ##    ##  ##  ##  ##  ##
##  ##    ##  ####    ##  ##  ##
##  ####  ##    ##  ##    ##  ##
####      ##  ##      ##      ##
##    ######      ####  ########
##  ##      ####  ##          ##
##      ##            ##  ##    
################################
