################################
          ##  ##  ##          ##
##  ####          ##  ##  ##  ##
##  ######  ####  ##  ##  ##  ##
##    ##    ##    ##  ##  ##  ##
##  ##    ##########  ##    ####
####    ##  ##        ####    ##
####  ##        ######      ####
##    ##  ##  ##    ##  ##    ##
##  ####    ##    ##      ######
##      ##  ##  ##    ##      ##
####  ##        ######    ##  ##
##        ######      ####    ##
####  ####    ##  ##        ####
##        ##        ##  ##      
################################
