################################
              ##  ##          ##
##  ##  ####          ##  ##  ##
##  ##  ##    ########  ##    ##
##    ##    ####          ##  ##
####    ##        ######  ##  ##
##  ##  ####  ##      ##    ####
##  ##      ##  ######  ##    ##
##      ####            ####  ##
####  ##      ##  ####        ##
##    ##  ####  ##    ##  ##  ##
##  ##    ##        ##  ##    ##
##    ##    ##  ##      ##  ####
##  ##    ##      ##  ####  ####
##  ##  ##    ##  ##            
################################
