################################
      ##        ##  ##        ##
####      ####  ##      ##  ####
##  ##  ######    ########    ##
##  ##    ##  ##          ##  ##
##    ##  ##    ########      ##
####  ##  ####          ####  ##
##    ##      ##  ##  ##      ##
##  ##    ##  ##    ####  ######
##  ##  ##    ####  ##    ##  ##
##  ##  ##  ##      ##  ####  ##
##    ##    ##  ##  ##        ##
##  ##    ##    ####  ######  ##
##    ##  ##  ##          ##  ##
####      ##      ##  ##        
################################
