################################
          ##  ##        ##    ##
##  ######        ####      ####
##        ####  ##    ####    ##
##  ####  ##    ##  ##    ##  ##
####  ##    ##  ##      ##    ##
##      ##  ##    ####    ##  ##
##  ####      ##      ##      ##
##    ##  ##  ##  ##  ##  ######
####  ##    ##    ##  ##      ##
##      ##    ##  ##    ##  ####
##  ##    ##  ##    ##  ##    ##
##  ####      ##  ##    ####  ##
##    ########  ##    ##  ##  ##
####                ##          
################################
