################################
            ##  ##          ####
##  ##  ##  ##      ##  ##    ##
##  ##  ##  ####  ######  ######
##  ##  ##    ##    ##        ##
##  ##    ##      ##    ####  ##
####    ######  ##    ##      ##
####  ######  ##    ##  ##  ####
##      ##    ##  ##        ####
##  ##      ####    ##  ####  ##
##    ####  ##    ##  ##  ##  ##
##  ##  ##  ##  ##            ##
##  ##      ##  ####  ######  ##
##  ########        ##        ##
##            ####      ####    
################################
