################################
            ##                ##
##  ##  ##      ####  ######  ##
##  ##  ########    ##        ##
##  ##        ####      ########
##  ########      ##  ##      ##
##          ####    ##    ##  ##
##########      ##      ##    ##
##      ##  ##    ##  ######  ##
##  ##    ######    ##  ##    ##
##    ##    ##    ##      ##  ##
######  ##      ##    ##      ##
##        ######    ##  ##  ####
##  ######      ##  ##        ##
##          ##      ##  ####    
################################
