################################
      ##      ##    ##      ####
##  ##    ##      ##    ##    ##
##  ##  ##  ####      ##  ##  ##
##      ##    ######  ##  ##  ##
##  ####  ##        ##    ##  ##
##    ##  ##  ####      ##    ##
####  ##  ##    ####  ##    ####
##    ##      ##        ##    ##
##  ####  ####    ####    ##  ##
##  ##    ##    ##      ##    ##
##  ########  ##  ####    ##  ##
##            ##      ##  ##  ##
##############  ##  ####  ##  ##
##                        ##    
################################
