################################
      ##              ##      ##
####  ##  ##  ######    ##  ####
####  ##  ##        ##        ##
##    ##    ##  ##    ####  ####
##  ##    ##      ##      ##  ##
##      ##  ##  ####  ####    ##
##  ####      ##      ####  ####
##      ####  ##  ####      ####
######    ##  ##    ##  ####  ##
##      ##    ####  ##  ##    ##
##  ######  ##      ##    ##  ##
##          ##  ##    ##  ##  ##
########  ####    ####        ##
##            ##        ####    
################################
