################################
        ##          ##      ####
##  ##  ##  ##  ##      ##    ##
####    ##    ##  ####    ######
####  ##  ##  ##      ##      ##
##        ##  ##  ####  ####  ##
##  ##  ##    ##  ##    ##    ##
##  ##  ##  ##        ##    ####
##    ####      ##  ##    ##  ##
####      ####    ########    ##
##    ##      ##    ##    ##  ##
##  ####  ##  ####    ##      ##
##      ##        ##    ####  ##
##  ##    ########  ##  ####  ##
##    ##                        
################################
