################################
      ####        ##  ##      ##
####        ##  ##        ##  ##
########  ##    ##  ##  ##  ####
####      ##  ####  ##        ##
##    ##    ##      ########  ##
##  ##  ##  ##  ####      ##  ##
##      ####    ##    ##  ##  ##
##  ##        ##    ##    ##  ##
##  ##  ######    ##    ##    ##
##    ####    ##    ##    ##  ##
####        ##  ##  ####  ##  ##
##  ######      ##      ##  ####
##        ####  ######        ##
##  ####                ####    
################################
