################################
      ##                      ##
####  ##  ########  ##  ####  ##
####      ##    ##    ##      ##
##    ##      ######  ######  ##
##  ##    ##    ##          ####
##  ##  ######    ##  ####    ##
##    ##  ##  ##    ##      ####
##  ##    ##  ##  ##    ####  ##
##    ##        ##    ##  ##  ##
##  ##  ######      ##        ##
##      ##    ######    ####  ##
######      ##      ####      ##
##    ####  ##  ##  ##    ##  ##
####            ##      ##      
################################
