################################
    ##  ##          ##        ##
##          ##  ##      ####  ##
##  ####  ##    ########      ##
##      ##  ##        ##  ##  ##
####  ##      ####  ##    ######
##  ##    ##      ####  ##    ##
##  ##  ##  ##  ##        ##  ##
##      ##      ##  ####  ##  ##
##  ####    ####        ##    ##
##      ##    ####  ####    ####
##  ##  ####        ##    ##  ##
##  ##    ##########    ##    ##
##  ####          ##  ##  ##  ##
##      ##  ####                
################################
