################################
    ##      ##            ##  ##
##      ##    ####  ####      ##
############        ##    ##  ##
##      ##  ##  ##  ##  ##    ##
##  ##        ##  ##    ####  ##
##    ##  ##      ##  ##      ##
##  ######  ####  ##  ######  ##
##  ######  ##    ##        ####
##    ##    ##  ##    ####    ##
####      ####  ######      ####
##  ####  ##        ##  ##  ####
##      ##    ####      ##    ##
##  ####    ##    ########  ####
##        ######                
################################
