################################
    ######          ####  ##  ##
##    ##    ##  ##            ##
####  ##  ##      ####  ##  ####
##    ##  ##  ####  ##  ##    ##
##  ##      ####    ##    ##  ##
##      ##        ##  ##    ####
####  ######  ##  ##    ##    ##
##      ##  ##        ######  ##
########      ######    ####  ##
##        ##      ##  ##      ##
##  ############  ##  ##  ##  ##
##  ##    ##  ##    ##    ##  ##
##  ####      ####  ####  ##  ##
##      ####              ##    
################################
