################################
            ##          ##    ##
##  ####  ####  ########  ##  ##
####      ##    ##            ##
##    ##    ##    ##  ####  ####
##  ##  ##    ##  ##  ##      ##
##  ##    ##  ##  ####    ######
##    ##  ##  ##      ##      ##
####        ##  ####  ##  ##  ##
####  ####      ####    ##    ##
##        ##  ##      ##    ####
##  ##  ####  ##  ####  ##    ##
##    ##      ##  ####    ##  ##
####  ##  ####        ##      ##
##    ##        ####      ##    
################################
