################################
          ##        ##  ##    ##
####  ##      ####        ##  ##
##      ######      ####  ##  ##
####  ##      ##  ##      ##  ##
##      ####    ##    ####    ##
##  ####  ##  ##    ##      ####
##        ##  ####      ##    ##
######  ####      ####  ##  ####
##      ##  ####      ##      ##
##  ##          ####  ##  ##  ##
##  ##  ######    ##  ##  ##  ##
##    ##      ######    ##    ##
##  ####  ##        ##  ##  ####
##          ##  ##      ##      
################################
