################################
                      ##      ##
##  ##  ####  ######  ##  ##  ##
####    ######        ##    ####
##    ##  ##    ##  ##  ##    ##
##  ####    ####    ##      ####
##      ##        ####  ##    ##
##  ##  ##  ######        ##  ##
##  ##  ##      ##  ##  ##    ##
####    ######    ##    ##  ####
##    ##      ##    ####      ##
##  ####  ##    ##        ##  ##
##  ##    ####  ##  ########  ##
##  ##  ##    ##  ##          ##
##          ##        ##  ##    
################################
