################################
                              ##
########  ########  ########  ##
##        ##    ####      ##  ##
##  ##  ##  ##        ##  ##  ##
##  ####      ########    ##  ##
##        ####      ##  ##  ####
####  ####      ##      ##    ##
##        ##  ##  ######  ##  ##
####  ##          ##  ##      ##
##    ##  ####  ##      ####  ##
##  ##  ##  ####    ##  ##    ##
##  ##            ##    ####  ##
##    ######  ######  ##      ##
####          ##          ##    
################################
