################################
      ####      ##    ##  ##  ##
####        ##    ##          ##
####  ##  ######    ##  ####  ##
##    ##    ##    ####    ##  ##
####  ####  ##  ##      ##    ##
##      ##  ##      ########  ##
##  ####    ########    ##    ##
######    ##          ##    ####
##      ##    ####  ##    ##  ##
##  ######  ##  ##      ##    ##
##        ##        ####  ##  ##
####  ##  ##  ##  ##          ##
##  ####  ##    ##    ######  ##
##          ##      ##          
################################
