################################
                  ##      ##  ##
##  ######  ####      ##      ##
####        ##########  ####  ##
##    ####    ##            ####
####  ##    ##    ####  ##    ##
####  ##  ##    ##    ##  ##  ##
##      ##    ######      ##  ##
##  ##  ##  ##  ##    ##      ##
##  ####    ##  ##  ######  ####
##    ##  ##    ##    ##  ##  ##
####    ##    ##    ##        ##
######    ##      ##    ####  ##
########    ####  ##  ##  ##  ##
##########            ##        
################################
