################################
            ##    ##      ##  ##
##  ######    ##      ##      ##
##  ##  ####  ##  ##  ####  ####
##  ##    ##    ##      ##    ##
##  ####    ##  ##  ####  ##  ##
##      ##        ##          ##
####  ##    ####  ##  ##  ##  ##
##      ##      ##      ##  ####
##  ##    ####      ######    ##
##    ##      ##  ##      ##  ##
##  ##  ##  ######    ##  ##  ##
##      ##    ##    ####      ##
##  ####  ##    ##      ########
##          ##      ##          
################################
