################################
      ##      ##              ##
####      ##      ##  ##  ######
####  ##  ########      ##    ##
##    ##        ##  ##  ####  ##
####    ######    ######      ##
##  ##        ##    ##    ######
##    ##  ##  ##  ##    ##    ##
##  ##    ######  ##  ##  ##  ##
##  ##  ##        ##  ##      ##
##  ##  ##  ##  ##    ##  ##  ##
##      ##  ####    ##  ##    ##
##  ##  ##    ##  ##        ####
##  ####  ##          ####    ##
##          ##  ####      ##    
################################
