################################
        ##              ##    ##
##  ##      ##########      ####
##    ##  ##          ####    ##
####    ##  ##  ####        ####
##  ##  ##      ##    ##  ##  ##
##        ##  ##    ##        ##
####  ##    ##    ##  ######  ##
##      ##  ##  ##        ##  ##
##  ##  ##  ####    ####    ####
##    ####    ##  ##    ##    ##
####      ##  ##      ##  ##  ##
######  ##    ######      ##  ##
####      ##          ######  ##
##    ##    ##  ##  ##          
################################
