################################
      ##        ##          ####
####      ######    ######    ##
##    ####      ##  ##    ##  ##
####        ##  ##      ##    ##
##  ######  ##      ##  ##  ####
##        ####  ##    ####    ##
####  ##      ########      ####
##    ##  ##  ####      ##    ##
##  ##  ####        ####  ##  ##
##  ##        ##  ##      ##  ##
##  ##  ##  ##  ##    ##    ####
##  ##    ####      ##  ##    ##
##  ######      ######      ####
##          ##        ####      
################################
