################################
    ##            ####        ##
##      ##  ######      ####  ##
##  ######  ##      ########  ##
####        ##  ####    ##    ##
####  ######          ####  ####
##    ##      ##  ######      ##
##  ##    ########        ##  ##
##  ##  ##    ####  ########  ##
##  ##  ##  ##      ##      ####
##  ##  ##  ##  ##  ##  ##    ##
##          ##  ##  ##    ##  ##
##  ####  ##      ##    ##    ##
##      ##    ######  ##  ##  ##
##  ##    ##              ##    
################################
