################################
      ####          ##        ##
####      ##  ##  ####  ####  ##
##    ##  ##    ##        ##  ##
####  ##    ##      ######    ##
##      ##    ##  ##    ##  ####
##  ##  ####  ##      ####    ##
##  ##    ##    ##  ####  ##  ##
##    ####    ##          ##  ##
####      ####    ##  ##  ##  ##
##  ####  ########  ######    ##
##          ##        ##    ####
##  ########    ####      ##  ##
##            ##  ######  ##  ##
##  ##  ##  ##                  
################################
