################################
    ##                        ##
##      ####  ######  ####  ####
##  ####    ####      ####    ##
##  ##    ##      ####      ####
##      ##    ####      ##    ##
##  ##    ##    ####  ######  ##
##    ##    ##      ######    ##
####    ####  ####    ##    ####
##  ##            ##    ##    ##
##      ##  ##  ##    ##  ##  ##
##  ####  ####  ##  ##    ##  ##
####          ####  ##  ##    ##
##    ######  ##    ##    ##  ##
##  ##            ######        
################################
