################################
              ####            ##
####  ##  ####      ####  ##  ##
##    ##        ####  ##  ##  ##
##  ##  ####  ##      ##  ##  ##
##      ##  ##  ##  ##    ##  ##
######  ##            ##  ######
##  ##  ##  ##  ####  ##      ##
##      ##  ##    ##    ####  ##
##  ####      ##  ##  ##    ####
##    ##  ##    ##      ##    ##
####    ##  ######  ##    ##  ##
##  ##              ####  ##  ##
##  ################  ##  ##  ##
##                              
################################
