################################
    ######    ##    ##        ##
##    ##    ##    ##    ##  ####
####      ##    ######    ##  ##
##    ##      ##  ##    ##    ##
##  ##  ##  ##        ##    ####
##  ##  ##      ##  ##  ##    ##
##  ##    ##  ##  ##      ##  ##
##  ####    ##        ##      ##
##      ##      ##  ##  ####  ##
##  ##    ##  ####        ##  ##
####  ##    ##      ####    ####
##      ##  ########    ##    ##
##  ####              ##  ##  ##
##        ##  ##  ##            
################################
