################################
            ####    ##        ##
####  ####      ##      ##  ####
##    ##  ####    ##  ##      ##
##  ##        ##      ##  ##  ##
####  ##  ##    ######  ##    ##
##    ##  ##  ##    ##  ##  ####
##  ##    ##    ##      ##    ##
##      ######  ##  ##      ####
##  ##    ##    ##    ##  ##  ##
##  ##  ##    ######    ##    ##
##    ##    ##  ##  ##      ####
####    ####          ####    ##
######    ##  ##  ####  ####  ##
########      ##                
################################
