################################
                ##            ##
##  ######  ##    ####  ####  ##
##      ##    ##    ##  ####  ##
##  ####  ##    ##  ##      ####
####          ##    ##  ##    ##
####  ####  ##    ##  ##  ##  ##
##  ########    ##            ##
##    ####    ##  ##  ##  ##  ##
####        ##    ##  ##    ####
##    ##  ##    ##      ##    ##
####    ######      ##  ####  ##
##  ##    ##  ####    ##      ##
##    ##          ####    ##  ##
####      ##  ##        ##      
################################
