################################
      ##    ##  ##  ##        ##
####      ##        ##  ##  ####
##  ####  ##  ####  ##  ##    ##
##        ##  ##    ##    ##  ##
####  ####      ##      ####  ##
##    ##    ####  ##  ##      ##
##  ####  ####      ##    ##  ##
##              ##  ##  ####  ##
##  ######  ##  ##  ##  ##    ##
####      ##      ####    ##  ##
##    ##  ##  ##      ##    ####
####  ####  ##  ##  ##  ##    ##
##      ##      ####        ####
##  ##      ##        ####      
################################
