################################
    ##        ##      ##      ##
##    ##  ##      ##    ##  ####
####        ####  ######      ##
####  ####  ######        ##  ##
##      ##    ####  ##  ####  ##
##  ####  ##          ####    ##
##        ######  ####      ####
####  ##        ##      ##    ##
##  ##    ######    ##    ##  ##
##      ##        ######    ####
##########  ##  ##  ##  ##    ##
##          ######  ##    ##  ##
##  ########        ##  ####  ##
##            ##  ##            
################################
