################################
        ##        ##        ####
##  ##      ####    ##  ##    ##
##    ####  ######        ##  ##
####    ##    ##    ########  ##
##    ##  ##    ####        ####
####  ##    ##    ##  ####    ##
##    ##  ######  ##    ##  ####
##  ##    ####      ##  ##    ##
##  ####        ####      ##  ##
##    ######  ##      ######  ##
####        ##    ####        ##
##    ####      ##      ####  ##
##  ####  ####  ##  ####  ##  ##
##            ##    ##          
################################
