################################
          ##      ######      ##
##  ##  ##    ##    ##    ##  ##
####        ##    ##    ##    ##
####  ####    ##    ##  ##  ####
##    ##    ##  ##  ##  ##    ##
##  ##    ####  ##    ######  ##
##  ##  ##        ##    ##    ##
##  ##  ##  ######  ##  ##  ####
##    ##    ##      ##  ##    ##
####      ##    ##  ##    ##  ##
##  ########  ##      ##      ##
##  ##          ##########  ####
##  ##  ##  ####      ##      ##
##      ##        ##      ##    
################################
