################################
          ##            ##    ##
####  ##    ##  ##  ####    ####
##      ##  ##  ##        ##  ##
##  ##  ##    ##    ##  ##    ##
##    ##  ##  ##  ##        ####
####  ##  ##  ##  ##  ####  ####
##    ##  ##  ##  ##    ##    ##
####  ##        ##    ##  ##  ##
##    ##  ##  ##    ##        ##
####    ####      ####  ####  ##
##    ##    ##  ##      ##  ####
##  ##    ##  ##  ##  ####    ##
##      ##        ##      ##  ##
##  ####    ####      ##        
################################
