################################
      ##    ##  ##            ##
####      ##        ########  ##
##    ##      ####          ####
####    ##  ##    ########    ##
##  ##  ##  ##  ##        ##  ##
##  ##    ##        ##  ##    ##
##    ##      ##  ##    ##  ####
####    ##  ######    ##      ##
####  ##  ##  ##    ####  ##  ##
##    ##          ##    ##  ####
##  ####  ##  ######  ##      ##
##  ##    ####          ####  ##
##    ##      ##  ####    ##  ##
####      ##          ##        
################################
