################################
                  ####    ##  ##
######  ####  ##        ##    ##
##      ##  ####  ##  ##    ####
##  ######          ####  ##  ##
##  ##      ##  ####      ##  ##
##  ##  ##    ##      ####    ##
##  ##    ##  ##  ####      ####
##    ##    ##    ##  ####    ##
####    ######  ##        ##  ##
##    ##        ##  ##  ##    ##
##  ##    ######    ##    ##  ##
##      ##    ##  ##  ##      ##
##  ######  ##    ##    ####  ##
##              ######          
################################
