################################
          ####            ##  ##
####  ##      ##  ######      ##
####    ####  ##        ####  ##
##    ##      ##  ####    ##  ##
##  ##    ####  ##      ##    ##
##  ##  ##  ##      ##  ########
##  ##        ####    ##      ##
##  ########  ##    ##    ##  ##
####      ##    ##      ####  ##
##    ######  ##    ####      ##
####          ##  ##      ##  ##
##    ########  ##    ####    ##
##  ##      ##  ##  ##      ####
##      ##          ##  ##      
################################
