################################
    ##      ####          ##  ##
##  ##  ##        ######      ##
##  ##    ##  ######  ##  ##  ##
##  ####    ##        ##  ######
##      ##      ####  ##      ##
##  ##    ######  ##    ####  ##
##  ##  ##        ####    ##  ##
####    ####  ##        ##    ##
####  ##      ##################
##    ##  ####          ##    ##
##  ####  ##    ##  ##      ####
##  ##      ##  ##    ####    ##
##      ##    ##    ##  ##  ####
##  ##    ##      ##            
################################
