################################
    ##  ####      ##    ####  ##
##            ##  ##  ##      ##
##  ######  ####  ##  ##  ######
##      ##  ##        ##  ##  ##
##########    ##  ####    ##  ##
##        ##    ##      ##    ##
##  ####      ##    ####  ##  ##
##  ####  ####  ##    ##      ##
##      ##        ##    ##  ####
##  ##      ##  ##  ##  ##    ##
##  ##  ######      ##      ####
##    ####    ##  ##  ####    ##
####      ##  ##  ##      ##  ##
##    ##      ##      ##        
################################
