################################
    ####                      ##
##        ######  ######  ##  ##
##  ##  ##      ##        ##  ##
##  ####    ####    ##  ##    ##
##      ##      ##    ##  ##  ##
######    ####    ##  ##  ##  ##
##      ##      ##    ##      ##
##  ##  ##  ##  ##  ##    ##  ##
##  ####      ##    ##  ##  ####
##        ####    ##    ##    ##
##########      ####  ##    ####
##          ######      ##    ##
##  ########      ########  ####
##            ##                
################################
