################################
      ##  ##  ##            ####
##  ##            ##  ##  ##  ##
##      ##  ##  ##  ##  ####  ##
##  ####    ####              ##
##      ##        ##############
####  ########  ##            ##
##      ##    ##  ##  ####  ####
##  ##    ##          ####    ##
####    ##  ########      ##  ##
##    ####        ######    ####
##  ####    ####        ##    ##
##        ##    ######    ##  ##
##########  ##  ##  ##  ####  ##
##                              
################################
