################################
            ##        ##  ######
##  ##  ##      ####  ##    ####
##  ##    ##  ##      ####    ##
##    ##    ####  ####    ##  ##
####  ####  ##        ##  ##  ##
####    ##    ####  ##        ##
##    ######  ##      ####  ####
####    ####    ####          ##
##  ##      ##      ############
##    ##  ##  ####            ##
####  ##      ##############  ##
##      ##  ##  ##        ##  ##
##  ######  ##  ##  ####  ##  ##
##          ##      ##          
################################
