################################
      ##        ##        ##  ##
####      ##  ##    ##  ##    ##
##  ##  ##  ##    ##        ####
##          ##  ##    ####    ##
##  ####  ##      ##  ##  ######
##    ##    ####  ##          ##
####    ##          ##  ####  ##
##  ##  ##  ##  ##  ##  ##    ##
##        ##  ####    ##    ####
##  ######        ####    ##  ##
##      ##  ####      ##  ##  ##
######    ##    ####      ##  ##
##  ####      ####  ########  ##
##        ##                    
################################
