################################
      ##  ########      ####  ##
####        ####    ##        ##
##    ####        ##    ##  ####
##  ####  ####  ##  ####    ####
##            ##        ##    ##
########  ####    ####    ##  ##
##      ##      ##    ##      ##
##  ##      ##    ##    ####  ##
##    ####    ##      ##    ####
####      ####  ########  ##  ##
##    ####                ##  ##
##  ##      ########  ####    ##
##  ####  ####      ##      ####
##              ##      ##      
################################
