################################
            ##        ##  ##  ##
####  ##  ##    ####  ##      ##
##    ##    ##  ##    ##  ##  ##
##  ##  ##  ####  ##  ##  ##  ##
##      ##        ##  ##  ##  ##
##  ##    ##  ##  ##  ##  ##  ##
##    ##  ##  ######    ##    ##
######  ##          ##      ####
##        ######  ##  ####    ##
##  ####  ##              ##  ##
##  ##        ####  ########  ##
##  ##  ############          ##
##    ##      ####    ##  ######
####      ##        ##          
################################
