################################
      ##  ##                ####
##  ##      ####  ####  ##    ##
##      ##  ##    ####    ##  ##
##  ####        ##    ##    ####
##  ##    ######  ##    ##    ##
##  ######        ####    ##  ##
##        ##  ##      ##      ##
##  ####  ##  ####  ##    ######
####      ##      ####  ##    ##
##    ####    ##  ##        ####
####  ##    ##        ######  ##
##    ####    ########        ##
####      ####          ####  ##
##    ##        ##  ##  ##      
################################
