################################
    ##  ##          ##    ######
##          ##  ##  ####    ####
##  ########    ##    ####    ##
##        ##  ##  ##      ##  ##
##  ##  ##    ##    ##  ##    ##
####  ####  ##  ##  ##  ##  ####
##    ##    ##          ##    ##
##  ##    ##  ####  ##  ####  ##
##  ##  ####      ####    ##  ##
##  ##        ##  ##  ##  ##  ##
##    ########    ##  ##      ##
####            ##    ######  ##
##  ############  ##      ##  ##
##                    ##        
################################
