################################
    ####        ##        ##  ##
##        ####  ##  ####      ##
####  ####        ##      ##  ##
##        ##  ##      ##    ####
##  ####    ########    ####  ##
##      ##  ####    ##    ##  ##
##  ######      ##      ##    ##
####      ####  ##  ####    ####
##    ##  ##    ##      ##    ##
####  ##  ##  ##  ######  ##  ##
##    ##      ##              ##
####    ####  ##  ##  ##########
##  ##      ##      ####      ##
##      ##      ##        ##    
################################
