################################
                  ##        ####
##  ##  ####  ##  ##  ####    ##
##  ##    ##  ##  ##  ##  ######
##    ##  ##  ##  ##          ##
####    ##    ##    ##  ####  ##
##    ##    ##  ##  ####      ##
##  ##    ##    ##      ##  ####
####    ######    ####  ##    ##
####  ##  ##    ##          ####
##    ##      ##    ########  ##
##  ##    ##      ##          ##
##    ####  ########  ######  ##
##  ##                      ####
##      ##  ##  ##  ##  ##      
################################
