################################
      ####            ##      ##
####        ########      ##  ##
##  ##  ####        ######    ##
##      ##  ##  ##          ####
##  ##        ##    ########  ##
##    ######  ######          ##
##  ##    ##        ##  ##  ####
##  ####    ######      ##    ##
##    ####        ######    ####
####    ##  ####      ##  ##  ##
##  ##  ##    ######    ####  ##
##      ##  ##        ##      ##
##  ####  ##    ####  ##  ##  ##
##            ##          ##    
################################
