################################
                            ####
##  ####  ##  ##  ########    ##
######      ##    ##      ##  ##
##    ####    ##  ##  ##  ##  ##
##  ######  ##    ##  ##      ##
##    ##    ##  ######    ######
####    ####    ####    ##    ##
##  ##  ##    ##      ####  ####
##  ##      ##    ##  ##      ##
##    ######    ######    ##  ##
####      ##  ##  ##    ##    ##
##    ##  ##  ##      ##    ####
####    ##        ######  ##  ##
######      ##  ##              
################################
