################################
                ##    ######  ##
##  ##  ######    ##    ##    ##
##    ##      ##    ##      ####
####      ##  ####      ##    ##
##  ######        ##  ##  ##  ##
##        ##  ##  ##        ####
##  ####    ####    ####  ##  ##
##  ##  ##      ##      ##    ##
##        ####    ####  ##  ####
########      ##    ##  ##    ##
##    ######    ##      ##  ####
##  ##        ##  ######      ##
##  ##  ######        ##  ##  ##
##              ####      ##    
################################
