################################
      ##  ##  ##        ##    ##
##  ##          ##  ##      ####
##      ##  ##    ##    ##    ##
##  ####  ##  ##  ##  ##  ##  ##
####          ##    ##        ##
##    ######      ##    ##  ####
####      ####  ##    ##  ##  ##
####  ##      ##    ####      ##
##    ######    ##        ##  ##
##  ##      ##  ########    ####
##  ##  ##  ##          ##    ##
##    ##      ##  ##  ##    ####
##  ####  ##    ##    ##  ##  ##
##          ##    ##            
################################
