################################
            ##            ######
##########    ##  ##  ##    ####
##        ##      ##  ####    ##
##  ####    ##  ####      ##  ##
##      ##  ##      ####  ##  ##
##  ##  ##    ####    ##  ######
##    ######      ##  ##      ##
####    ##    ####      ####  ##
##  ##    ######    ##    ##  ##
##      ##        ##  ##  ##  ##
##  ####    ######      ##    ##
##      ##  ##      ##      ####
######  ######  ####    ##    ##
##              ##    ######    
################################
