################################
    ##      ####    ##      ####
##      ##        ####  ##    ##
####  ####  ##  ##        ##  ##
##    ##      ##    ##  ##    ##
##  ##    ####    ##    ##  ####
##    ##    ##  ##  ##  ##    ##
####    ##  ##  ##        ##  ##
##  ##    ####    ##########  ##
##    ##  ##    ##            ##
####  ##      ##    ####  ##  ##
##    ########  ##  ####  ##  ##
##  ##          ##      ##    ##
##  ####  ####    ####  ##  ####
##            ##        ##      
################################
