################################
                  ##  ##      ##
##  ######  ##  ##      ####  ##
##  ##      ##  ##  ##    ##  ##
####    ##    ##    ##  ##    ##
####  ##    ####  ##    ##  ####
##    ######        ##      ####
##  ##        ######  ####    ##
##  ##  ##  ##            ##  ##
##  ##    ####  ##  ##  ##    ##
##  ####      ####    ####  ####
##      ####      ##  ##    ####
##  ##      ######    ##  ##  ##
####    ##      ####  ##  ##  ##
##    ##    ##                  
################################
