################################
          ##                  ##
##  ####    ########  ##  ##  ##
##      ##        ##    ##    ##
####  ##  ##  ##    ##  ####  ##
##    ##    ##    ####      ####
##  ##  ##      ##      ##    ##
##  ##      ######  ##    ##  ##
##  ######        ####  ##    ##
##        ######      ##    ####
##  ####        ####    ##    ##
####    ######  ######  ##  ####
##    ##      ##  ##    ##    ##
##  ##  ####        ##  ####  ##
##            ####              
################################
