################################
    ##      ####    ##      ####
##      ##        ##    ##    ##
####  ####  ##  ##    ##  ##  ##
##    ##      ##    ####  ##  ##
##  ##    ##  ##  ##      ##  ##
##  ############  ##  ##  ##  ##
##        ##            ####  ##
##  ####      ####  ####      ##
##      ####  ##  ##      ##  ##
##  ######        ##  ##    ####
####      ##  ##  ##    ##    ##
########  ####  ####  ##    ####
####                  ##  ##  ##
##    ####  ##  ##  ##          
################################
