################################
    ##      ##            ##  ##
##  ##  ####    ####  ##      ##
##  ##  ##    ##      ######  ##
##      ####    ##  ##    ##  ##
##  ####    ##  ##    ##  ##  ##
##  ##  ##      ##  ####      ##
##  ##    ########      ##  ####
##      ##        ####    ##  ##
######      ####    ####      ##
##    ######  ####    ####  ####
##  ##    ##      ##        ####
##      ####  ##  ########    ##
##  ######    ##          ##  ##
##          ##    ##  ##        
################################
