################################
            ##        ##  ##  ##
##  ######      ##  ##        ##
####      ########      ##  ####
##    ##          ##  ##      ##
##  ##  ########    ######  ####
##  ##  ##      ##  ####      ##
##      ##  ##  ##        ##  ##
########  ##      ##  ##    ####
##            ##    ######    ##
##  ######  ######    ##    ####
##      ##  ####  ##  ##  ##  ##
####  ##            ##        ##
##      ######  ####    ####  ##
##  ##      ##        ##        
################################
