################################
        ##  ##                ##
##  ####      ##  ##  ##########
##  ##    ##  ##  ##          ##
##      ####  ##    ##  ####  ##
##  ####      ########    ##  ##
##  ##  ##  ##        ####    ##
##  ##  ##      ####  ##    ####
##        ##  ##    ##    ##  ##
####  ##    ######      ##    ##
######  ##    ##    ##      ####
####      ##  ####    ####    ##
##    ######      ##  ##  ##  ##
##  ##      ####  ##  ##      ##
##      ##            ##  ##    
################################
