################################
      ##      ##  ####        ##
##  ##    ##            ####  ##
##      ##  ######  ####  ##  ##
##  ####        ##  ##        ##
##  ##    ####        ######  ##
####    ##    ####  ##      ####
####  ####  ####    ##  ##    ##
##    ##    ##    ##      ##  ##
##  ##    ##    ##    ######  ##
##  ####      ##    ##        ##
##      ##  ##    ##    ####  ##
##  ##  ##  ####  ##  ##    ####
##  ##  ####      ##  ####  ####
##  ##        ##  ##            
################################
