################################
        ##  ######        ######
##  ####      ##    ####    ####
##        ##      ##    ##    ##
##  ##  ######  ##    ######  ##
##    ##  ##  ##    ########  ##
####              ########    ##
##    ####  ##  ########    ####
##  ##    ##      ####    ######
####  ##    ##  ##      ########
##    ####      ##  ##    ######
####    ##  ######    ##    ####
##  ##  ##        ##    ##    ##
##  ##  ############  ####  ####
##                    ##        
################################
