################################
    ####        ##            ##
##        ####      ####  ##  ##
##  ######  ####  ##  ##    ####
##      ##      ##      ##    ##
######    ####  ##  ##    ##  ##
##    ##        ##  ##  ####  ##
####  ##  ####  ##  ##        ##
##    ##    ####    ####  ##  ##
##  ##  ##    ##  ##  ####    ##
##      ####  ##  ##        ####
##  ##    ##  ##  ##  ######  ##
##  ######    ##  ##  ##  ##  ##
##          ##    ##  ##      ##
##  ##  ####    ##        ##    
################################
