################################
              ##      ##      ##
####  ##  ##    ####      ##  ##
##    ####  ####  ####  ####  ##
##  ##      ##          ##    ##
##  ##  ##    ####  ####  ##  ##
##  ##    ##    ##    ##      ##
##  ##  ##  ##    ##  ##  ######
##  ##      ####      ##      ##
##  ######      ##  ##  ####  ##
##        ##  ##  ##          ##
########      ##      ##########
##    ########    ####        ##
##  ##          ####    ####  ##
##      ##  ##        ##        
################################
