################################
                ##    ####    ##
##  ##  ######    ##        ####
##  ##        ##    ##  ####  ##
##  ######  ##  ##  ##        ##
####        ##        ##  ##  ##
##    ##  ##  ######    ####  ##
####    ##          ##  ##    ##
##  ##    ##  ####  ##      ####
##      ######      ######    ##
##  ##    ##    ####      ##  ##
##    ##  ##  ##    ##  ##    ##
####  ##      ##  ##        ####
##      ######    ##  ######  ##
##  ##        ##                
################################
