################################
          ##  ##              ##
##  ##  ##        ########  ####
##  ##      ##  ####    ##    ##
##    ##  ##  ##      ##    ####
####    ##      ##  ##    ##  ##
##    ##    ##  ##  ##  ####  ##
##  ##    ##    ##  ##  ##    ##
##  ####    ####    ##      ####
##      ##  ######    ####  ####
##  ##  ##    ######    ##    ##
####      ##    ##  ##    ##  ##
##    ####  ##  ##  ####      ##
####  ##        ##    ##  ######
##        ##  ######            
################################
