################################
        ##      ##        ######
##  ####    ##      ##  ##  ####
##        ##########    ##    ##
##  ######  ##    ##  ##  ##  ##
##  ##  ##      ####      ##  ##
##  ##    ##  ##    ##  ####  ##
##    ##          ####        ##
##  ##  ##  ####      ##  ######
##  ##          ##  ##  ##    ##
##  ##  ######  ####      ##  ##
##  ##      ##        ##      ##
##    ####    ##  ####  ####  ##
####      ####    ##      ##  ##
##    ##        ##    ##        
################################
