################################
        ##      ##            ##
##  ######  ##  ##  ##  ####  ##
##  ##      ##    ##      ##  ##
##  ##  ########  ##  ##  ##  ##
##  ##      ##      ##    ##  ##
##    ####  ##  ##    ##  ##  ##
####    ##    ######      ##  ##
##  ##    ##  ####    ####    ##
##    ##  ##      ####      ####
####      ######      ##  ##  ##
##  ##  ##      ####  ##      ##
##      ##  ##    ##  ####  ####
##  ####      ##    ##        ##
##        ##    ##      ####    
################################
