################################
    ##  ##                    ##
##        ####  ##  ####  ##  ##
####  ##      ####  ##    ##  ##
##    ######  ##    ##  ##    ##
##  ##    ##    ####    ####  ##
##    ##  ####  ##    ##    ####
####  ##    ##      ##    ##  ##
##    ####      ##  ##  ##    ##
##  ##      ##    ##      ##  ##
##    ######  ##    ##  ##    ##
##  ##          ######      ####
##      ##  ####      ####    ##
##  ####    ##    ##  ####  ####
##      ##      ##              
################################
