################################
        ##    ##      ##      ##
##  ##    ##  ##  ##  ##  ##  ##
##  ##  ##        ##    ####  ##
##  ####    ######    ####    ##
##        ##    ##  ##      ####
##  ##########  ##    ##  ##  ##
##        ##    ####  ##      ##
######  ##    ##        ####  ##
##      ##  ##    ##  ##      ##
##  ####    ##  ##  ####  ######
##  ##    ##    ##        ##  ##
##    ##  ##  ##    ######    ##
##  ##    ##      ####      ####
##      ##    ##        ##      
################################
