################################
              ##      ##      ##
####  ##  ##  ##  ##  ######  ##
##    ####    ##  ##      ##  ##
####      ####      ####      ##
####  ##      ####  ##    ##  ##
##    ##  ##    ##  ##  ####  ##
##  ##  ##  ##  ##    ####    ##
##          ##    ##  ##    ####
######  ##  ##  ####  ##  ##  ##
##      ####    ##    ##      ##
##  ####      ##    ##  ####  ##
##  ##    ##    ####      ##  ##
##    ##    ####  ##  ##  ##  ##
####    ##            ##        
################################
