################################
      ##            ######    ##
####      ########    ##    ####
##    ##  ##      ##      ##  ##
######  ##    ##  ##  ##      ##
##          ####  ####    ##  ##
##  ####  ##          ####    ##
##  ##  ##    ######        ####
##  ##  ##  ##    ####  ##    ##
##  ##          ##    ##  ##  ##
##    ######  ##    ####      ##
####      ##  ##  ##      ######
##    ##  ####    ####  ##    ##
####  ##    ##  ##        ##  ##
##      ##      ##  ####        
################################
