################################
              ##              ##
##  ##  ####  ##  ####  ##  ####
####  ####    ##  ##  ##      ##
##          ####      ##  ##  ##
##  ##########  ######  ##    ##
##              ##      ##  ####
##  ##  ####  ##    ##  ##    ##
##    ##  ##  ##  ####    ##  ##
####      ##  ##      ##      ##
##  ####  ##    ####    ########
##    ##  ####    ####        ##
##  ####      ##      ####  ####
##      ##  ##  ##  ####      ##
##  ##          ##        ##    
################################
