################################
            ##  ######      ####
##  ####  ##      ##    ##    ##
##  ##    ##  ##      ######  ##
##    ##      ####  ########  ##
####  ####  ##      ######    ##
##        ##    ####  ##    ####
##  ######    ##          ##  ##
####        ##    ##  ####    ##
####  ##  ##  ##    ##  ##  ####
##      ##      ##  ##  ##    ##
##  ####    ##  ##      ##  ####
##  ##    ####    ########    ##
##  ##  ####  ##  ##      ##  ##
##            ##      ##        
################################
