################################
          ####          ##    ##
##  ####      ##  ####      ####
##      ####  ##    ##  ##    ##
######  ##      ##  ##  ##  ####
##  ##    ##  ##    ####      ##
##  ########    ##      ##  ####
##          ##    ####  ##    ##
####  ####    ##  ##      ##  ##
####  ##    ####  ##  ######  ##
##      ####      ##        ####
##  ####      ####    ####    ##
##  ##    ######  ####    ##  ##
##  ##  ##            ##      ##
##          ####  ##      ##    
################################
