################################
      ##                  ##  ##
##  ##    ##########  ####    ##
##      ####          ##    ####
##  ####      ######  ##  ##  ##
##      ##  ##    ##  ##      ##
##  ##  ##    ##        ####  ##
##    ##    ##    ####    ##  ##
##  ##    ##  ########  ##    ##
####    ##        ##    ##  ####
##    ##    ##  ##    ##      ##
####  ##  ##  ##    ##    ##  ##
####      ##      ##  ####    ##
##  ######    ##  ##      ##  ##
##          ##        ##        
################################
