################################
          ####    ##  ##      ##
##  ##  ##      ##        ##  ##
##  ##      ####  ####  ##    ##
##    ######            ##  ####
##  ##    ##  ##########      ##
##  ####      ##          ##  ##
##        ####  ##  ##  ##  ####
############    ##    ##      ##
##            ##  ##    ####  ##
####  ##  ####      ##    ##  ##
##    ##        ##    ##      ##
##  ##  ####  ##  ####  ####  ##
##      ##    ##          ##  ##
##  ##    ##      ##  ##        
################################
