################################
              ####    ##      ##
##  ########      ##      ##  ##
##          ####  ##  ######  ##
##  ####  ##          ##      ##
####      ##  ####  ##  ##  ####
##    ##    ##  ##  ##      ####
##  ####  ##      ##    ####  ##
##      ##    ##  ##  ##      ##
##  ##    ##    ####  ##  ##  ##
####    ##  ##  ##    ##  ##  ##
##    ##    ##  ##  ##  ##    ##
##  ##  ##      ##      ##  ####
##  ##      ####  ##  ##      ##
##      ####              ##    
################################
