################################
                          ##  ##
##  ########  ########  ##    ##
##          ##        ####  ####
##  ##  ##  ##  ####        ####
##  ######  ##      ##  ####  ##
####        ####  ##  ##  ##  ##
##    ######      ##          ##
##  ##        ####  ##  ####  ##
##  ##  ########            ####
##  ##  ##      ##  ##  ##    ##
##  ##  ##  ##  ##    ##  ##  ##
##  ##      ##    ####        ##
##  ########  ##        ##  ####
##                ##  ##        
################################
