################################
    ##  ##  ##  ##      ##    ##
##              ##  ##      ####
##  ####  ##  ##    ##  ##    ##
##  ##      ##    ##  ##    ####
##  ##  ##  ##  ##    ##  ##  ##
##    ##    ##  ##  ####      ##
####  ##  ####  ##      ##  ####
##    ####      ##  ##  ##    ##
####      ##  ##  ##    ##  ####
##    ##  ##      ####        ##
##  ####    ######  ##  ####  ##
##  ##  ##      ##        ##  ##
##        ##  ####  ####    ####
####  ##  ##            ##      
################################
