################################
      ##      ##      ##      ##
####      ##  ##  ##    ##  ####
##  ##  ##    ##    ##        ##
##      ##  ####  ######  ##  ##
##  ##    ##        ##    ##  ##
##    ##      ####    ##    ####
##  ##  ##############  ##    ##
##            ####        ##  ##
####  ##  ####      ##  ##    ##
##      ##      ####  ##    ####
##  ####    ####      ####    ##
##  ##    ##  ##  ##    ####  ##
##  ##  ##          ##    ##  ##
##  ##      ##  ##    ##        
################################
