################################
                ##            ##
##  ##  ####  ####  ####  ##  ##
##  ##    ####          ##    ##
##    ##        ##########  ####
####  ##  ######              ##
####    ##    ##  ##  ######  ##
##  ##  ####  ##    ##      ####
##  ##    ##    ##  ##  ##    ##
##    ##    ##  ##  ##    ##  ##
##  ####  ##    ##    ##  ######
##  ##    ##  ##  ##  ##      ##
##      ##        ##  ######  ##
####  ##    ##  ##  ##        ##
##        ##            ####    
################################
