################################
    ##        ##      ##      ##
##    ##  ##      ##    ##  ####
####      ##  ##    ####      ##
######  ##  ##    ##      ##  ##
####    ##  ##  ##    ##  ##  ##
##    ##    ##  ##  ######    ##
##  ######      ##    ##    ####
##    ##    ##  ##  ##    ##  ##
####  ##  ##    ##    ####    ##
####  ##  ######  ##        ####
##      ##        ########    ##
##  ####    ####        ####  ##
##  ##    ##  ##  ####    ##  ##
##      ##            ##        
################################
