################################
              ##              ##
##  ####  ####    ##  ##  ##  ##
##  ##          ##      ##    ##
##    ##  ######  ####    ##  ##
####    ##            ##    ####
##    ##    ##  ####    ##    ##
####  ##  ##  ####  ##      ####
##  ##    ##          ######  ##
##  ##  ##    ##  ####        ##
##  ##    ##  ##        ##  ####
##  ####    ##    ##  ####    ##
##    ####    ##  ##  ##  ##  ##
####    ####  ######  ##  ##  ##
######                ##        
################################
