################################
    ##          ##        ##  ##
##      ##  ##    ######      ##
####  ##    ####  ##      ##  ##
##      ##    ##      ######  ##
##  ####  ##    ######        ##
##    ##    ##  ##      ####  ##
##  ##    ##    ##  ##  ##  ####
##    ##  ####    ##    ##    ##
####  ##      ##    ##    ##  ##
####    ####    ##    ##  ##  ##
##  ##    ####    ##  ##      ##
##  ####      ##      ######  ##
##    ##  ####  ######    ##  ##
####                  ##        
################################
