################################
        ##      ##  ##        ##
####  ##    ##      ##  ##  ####
##      ##    ####  ##    ##  ##
##  ####    ##  ##    ##  ##  ##
##    ##  ##    ##  ##    ##  ##
##  ##      ##  ##    ##  ##  ##
##    ##  ##      ##      ##  ##
##  ####    ####    ########  ##
##  ##  ##        ##          ##
##        ##  ##  ##  ##  ######
##  ##  ##  ####    ####      ##
##    ##        ##  ##    ##  ##
####      ####  ##  ########  ##
##    ##    ##                  
################################
