################################
      ##                ##    ##
##  ##  ##  ######  ####    ####
##  ##      ##  ##        ######
##    ##  ####    ######    ####
####    ##      ##      ##    ##
##  ##      ##      ##  ####  ##
##      ####  ######      ##  ##
####  ##            ####  ##  ##
##    ##  ########      ##    ##
####  ##  ##      ####  ##  ####
##    ##    ####  ##    ##    ##
##  ##  ##        ##  ##  ##  ##
##  ##  ########  ##  ##      ##
##                ##      ##    
################################
