################################
        ####          ######  ##
##  ##      ##  ####    ##    ##
##    ####  ##  ##  ##      ####
####  ##    ##      ######  ####
####    ##  ######      ##    ##
##    ##          ####  ####  ##
####    ##  ####    ##      ####
##  ##    ##    ##    ####    ##
##  ####      ##  ##      ##  ##
##      ####        ####  ##  ##
##  ##      ######    ######  ##
##    ####        ##          ##
####  ##  ######    ########  ##
##              ##              
################################
