################################
            ##                ##
##  ######      ####  ####  ####
####      ##  ####    ##      ##
##    ##  ######    ##  ####  ##
####  ##          ##      ######
##      ##  ##  ##    ##      ##
##  ##  ##    ##    ##  ####  ##
##    ##  ##  ##  ##      ##  ##
####  ##      ##    ##  ##    ##
##    ########    ####    ##  ##
##  ##          ##      ####  ##
##  ##  ########  ##  ##      ##
##  ####      ##      ####  ####
##        ##      ##            
################################
