################################
          ##        ####      ##
########      ####        ##  ##
##    ##  ####    ##  ######  ##
##  ##    ##  ##  ##        ####
##    ##  ##      ##  ####    ##
####  ##  ##  ##    ####  ##  ##
##    ##      ##  ##          ##
##  ##  ##  ##  ##    ######  ##
##  ##    ##        ##    ##  ##
##    ##      ##  ######      ##
##  ##    ##    ##  ##    ######
##  ####    ##  ##      ##    ##
##      ####    ##  ######  ####
##  ##        ##                
################################
