################################
      ####  ##  ##      ##  ####
##  ##              ##  ##    ##
##  ##  ####  ##  ####    ##  ##
##  ##      ##  ##      ##    ##
##      ####    ##  ####    ####
########      ##    ##    ##  ##
##        ########      ##    ##
####  ##      ##  ####      ####
##    ######          ####    ##
##  ##    ##########      ##  ##
##  ####            ####      ##
##      ########  ##    ########
####  ##      ##      ##      ##
##        ##      ##      ##    
################################
