################################
            ####    ##        ##
##  ##  ##      ##      ##  ####
##  ##    ####    ##  ####    ##
####  ##    ##  ##    ##    ####
##        ##        ##  ##    ##
##  ##  ##    ######    ####  ##
##    ##    ####      ##      ##
####    ##  ##  ####      ######
####  ##    ##    ##  ##      ##
##    ##  ##  ##    ##  ####  ##
##  ##        ##  ##    ##    ##
##  ##  ########  ##  ####  ####
##    ####        ##          ##
####        ##  ##    ##  ##    
################################
