################################
          ##          ##  ##  ##
##  ##  ##    ######          ##
######      ##      ####  ##  ##
##      ####  ##  ####  ##    ##
##  ####                ##  ####
##  ##    ####  ##  ####    ####
####    ######    ##      ##  ##
####  ##  ##  ##      ######  ##
##    ##        ######        ##
####  ##  ##  ##        ####  ##
##    ##  ##  ##  ######  ##  ##
##  ##  ####      ##  ##      ##
##  ##      ##  ##        ##  ##
##      ##      ##  ##  ##      
################################
