################################
              ####            ##
##  ######  ##      ####  ######
##      ####    ####  ##      ##
##  ##        ##        ####  ##
####  ##  ######  ####    ##  ##
##      ##        ##    ##    ##
##  ##      ##  ##    ##    ####
##    ######      ##  ####    ##
####        ##  ##          ####
##    ####    ##    ######  ####
##  ##    ##  ##  ##    ##    ##
##  ##  ##    ##  ##  ##  ##  ##
##      ##  ##  ####  ##  ##  ##
##  ##  ##            ##        
################################
