################################
    ##  ##      ####          ##
##          ##        ######  ##
####  ######  ########    ##  ##
####      ##          ##  ##  ##
##  ######    ##  ##      ##  ##
##  ##      ##      ######    ##
##      ##    ##  ##        ####
############  ##  ##  ######  ##
##      ##    ##  ##      ##  ##
##  ##      ##      ####      ##
##    ##  ####  ##      ####  ##
##  ##  ##      ########      ##
##        ######      ##  ######
##  ####          ##            
################################
