################################
    ##            ##      ##  ##
##      ######  ##    ##      ##
####  ####  ##      ######  ####
##    ##    ######    ####    ##
##  ####  ##      ####      ####
##  ##      ####  ##    ##    ##
##  ##  ####      ##  ##  ##  ##
##  ##  ##    ####        ##  ##
##  ##    ##    ########    ####
##    ##    ##          ##  ####
####    ##    ######  ##      ##
##  ##    ##      ##    ####  ##
##  ##  ##  ##  ##  ##        ##
##                    ##  ##    
################################
