################################
    ##              ##        ##
##    ##  ####  ##      ####  ##
####    ####    ####  ##      ##
##  ##        ##  ##    ##  ####
##      ######      ##    ######
####  ##        ##    ##    ####
##        ######    ##  ##    ##
##########      ##        ##  ##
##          ##    ######  ##  ##
##  ############      ##  ##  ##
##  ##      ####  ##  ####    ##
##      ##      ####        ####
####  ##  ####      ######    ##
##            ####        ##    
################################
