################################
            ##    ##          ##
##  ######    ##  ##  ##  ##  ##
##  ##    ##          ##  ##  ##
##      ########  ####    ##  ##
##  ##  ####    ##  ##  ##    ##
####          ##        ##  ####
##    ##  ##  ##  ####    ######
##  ##  ##    ##  ##  ##    ####
####      ######  ##    ##    ##
##    ##  ##      ##  ##    ####
##  ##        ####    ##  ##  ##
####    ######      ##    ##  ##
##  ####      ##  ##  ##  ##  ##
##        ##                    
################################
