################################
        ##                    ##
##  ##    ##  ############  ####
####    ##  ##          ##    ##
##    ####      ############  ##
####        ##          ##    ##
##    ##  ##  ##  ####      ####
##  ######      ##    ######  ##
##    ##    ##    ##          ##
####  ##  ##    ##    ##  ##  ##
##        ####    ####    ##  ##
##  ##  ##    ##      ##    ####
####      ##    ####    ##    ##
##    ##  ####    ####  ####  ##
##  ##        ##                
################################
