################################
                ##            ##
##  ######  ####    ##  ####  ##
##  ##  ##      ##  ##  ##    ##
##  ##    ####    ##    ##  ####
##  ##  ##    ##    ##  ##    ##
##  ##      ##    ##    ####  ##
##    ##  ######      ##  ##  ##
##  ##      ##  ######    ##  ##
##  ##  ##              ##    ##
##    ##  ##  ##  ####      ####
####        ##        ######  ##
##    ####    ##  ##  ##  ##  ##
####  ##  ##    ##            ##
##          ####    ####  ##    
################################
