################################
            ##      ##        ##
####  ####  ##  ##      ##  ####
##    ####  ############      ##
##  ##          ##        ##  ##
##  ##  ######      ##  ##    ##
##    ##      ######  ##    ####
####      ##  ##      ##  ##  ##
##  ######    ##  ######      ##
##        ##  ##        ####  ##
##  ##  ##    ##  ##  ####    ##
##  ##  ##  ####  ##        ####
##  ##    ##        ########  ##
##    ##    ##  ####      ##  ##
####    ##            ##        
################################
