################################
              ##  ##      ##  ##
##  ########        ####      ##
##  ##      ##  ##        ##  ##
##      ##  ##  ####  ##  ##  ##
########    ##      ##  ##    ##
##      ##  ####  ##      ##  ##
##  ##  ##    ####    ##  ##  ##
####      ##        ##  ##    ##
##    ##    ####  ##    ##  ####
####  ####      ##    ##    ####
####      ####      ##    ##  ##
##    ##      ####    ##  ##  ##
##  ##  ####    ######        ##
##          ##          ####    
################################
