################################
        ######        ##      ##
##  ##    ##    ##  ##    ##  ##
##    ####    ##    ##  ##    ##
####        ##    ##    ##  ####
##    ##  ##    ##  ##  ##  ####
####    ##    ##      ##      ##
##    ##  ####    ##  ######  ##
##  ##      ####  ##          ##
##  ##  ##        ##  ######  ##
##      ##########  ##        ##
####  ##        ##      ##  ####
##  ##    ####    ##  ##  ##  ##
##    ##      ######  ##      ##
####      ##              ##    
################################
