################################
    ##        ##            ####
##      ######    ########    ##
##  ##        ####        ##  ##
##  ####  ##    ##  ####  ##  ##
##      ##  ##  ##  ##    ##  ##
######      ##    ##    ####  ##
##    ####    ##      ##      ##
##  ##    ##    ######    ##  ##
##  ##  ##    ##        ##    ##
##          ##    ##  ##    ####
##  ####  ##    ####  ##  ######
##  ##      ####      ##  ######
####    ##        ####      ####
##    ##    ##  ##      ##      
################################
