################################
    ####        ##  ##  ##    ##
##        ####            ##  ##
##  ######    ####  ####  ##  ##
##  ##    ##    ##  ##        ##
##      ####  ##    ##  ####  ##
##  ##        ####    ##  ##  ##
####  ####  ##      ##    ##  ##
####    ######  ##  ##  ##    ##
##  ##          ####    ##  ####
##    ##  ##  ##      ##    ####
##  ##  ##  ##    ##  ####    ##
##              ##  ##      ####
##  ####  ########      ####  ##
##    ##            ##          
################################
