################################
      ##  ##          ####    ##
####          ##  ##        ####
##    ######    ##  ######    ##
####  ##      ##    ##    ##  ##
####  ##  ####    ##    ##    ##
##    ##    ##  ##    ####  ####
##  ####  ##    ####  ##    ####
##      ##    ##          ##  ##
##  ##  ####    ##  ##  ##    ##
##  ##      ##    ####  ##  ####
##    ####    ##  ##    ##    ##
####      ##  ##    ##  ####  ##
##  ##  ####    ##  ##    ##  ##
##          ##        ##        
################################
