################################
            ##    ##  ####    ##
##  ######  ####  ##        ####
##  ##  ##        ####  ##    ##
##  ##    ##  ####      ####  ##
##      ##  ##      ####  ##  ##
######  ##      ####      ##  ##
##  ##    ##  ##      ######  ##
##      ##    ####  ##        ##
##  ######  ##      ##  ########
##            ##  ##    ##    ##
##############    ##  ######  ##
##              ##      ##    ##
####  ######  ##    ##      ####
##        ##      ##    ##      
################################
