################################
        ##  ##        ##  ######
##  ##  ##      ####  ##    ####
##  ##    ####    ##    ##    ##
##    ##      ##    ##    ##  ##
####    ####      ##  ##      ##
##    ##  ########      ####  ##
##  ##          ##  ####  ##  ##
####    ######      ##    ##  ##
##    ####  ##  ##      ##    ##
##  ##      ##    ####  ##  ####
##      ##    ##    ##  ##  ####
##  ##  ##  ##  ##  ##  ##    ##
####      ##    ##    ##  ##  ##
##    ##      ######            
################################
