################################
    ##      ##          ##    ##
##      ##  ##  ######    ##  ##
##  ##  ##  ##        ##      ##
##  ##  ##    ######    ####  ##
##    ##  ##        ##    ##  ##
####  ##    ####  ##    ##    ##
##    ####  ####  ####  ##  ####
##  ##  ##      ##      ##    ##
##  ##      ##      ####  ##  ##
##  ##  ####  ####  ##    ##  ##
##  ##          ##    ##      ##
##  ##  ######  ##  ##    ######
##    ##      ##    ####  ##  ##
####      ##      ##            
################################
