################################
                ####          ##
######  ##  ####      ##  ##  ##
##        ##  ##  ######    ####
##  ####  ##      ##    ##    ##
##  ##      ######    ##    ####
##  ##  ####        ##  ##    ##
##  ##        ####        ##  ##
##    ##  ##    ########  ##  ##
####  ##    ####        ##    ##
##    ##  ##      ####    ##  ##
##  ########  ######    ##    ##
##    ##      ##      ##    ####
##  ##    ##  ##  ####  ##  ####
##      ##    ##                
################################
