################################
    ####          ##      ######
##        ####  ##    ##    ####
######  ##      ##  ##  ##    ##
##      ######      ##    ##  ##
##  ####      ####    ##  ##  ##
##    ##  ##  ####  ##      ####
##  ##    ##      ##    ##    ##
##      ##  ####    ##    ##  ##
##  ####        ##    ####    ##
##    ##  ##  ##  ##        ####
####  ##  ##        ##  ####  ##
####  ####    ####    ##      ##
##      ##  ##  ##  ##    ##  ##
##  ##      ##          ##      
################################
