################################
            ##        ##      ##
##  ##  ##  ##  ####      ##  ##
######    ####      ##  ##    ##
##    ##        ######    ##  ##
##  ####  ######        ##    ##
##      ##        ######    ####
######      ######      ##    ##
##  ##  ####        ##  ####  ##
##    ##      ######  ##      ##
####      ####        ##  ######
##  ##  ##  ##  ####      ##  ##
##          ##      ######    ##
##  ########  ####  ##      ####
##                      ##      
################################
