################################
    ##      ##          ##    ##
##      ##      ##  ##      ####
####  ##  ####    ##    ##    ##
##          ####    ##    ##  ##
##  ######      ##    ######  ##
####      ##  ##    ##      ####
##    ##        ####    ##    ##
##  ####  ##  ##      ##  ##  ##
##      ##    ##  ####    ##  ##
##  ##  ##  ####  ##    ##    ##
####      ####    ##  ##  ######
##    ####      ####          ##
##  ##  ##  ####      ####  ####
##                ####          
################################
