################################
    ##      ##  ####      ##  ##
##    ##  ##          ##      ##
####      ##  ####  ##  ##  ####
##    ##          ##        ####
##  ##    ########    ######  ##
##    ##  ##        ####      ##
####    ####  ######      ##  ##
##  ##      ##      ##  ##    ##
##    ##  ##    ####      ##  ##
####  ##    ##        ##  ##  ##
####      ##    ######    ##  ##
##    ####  ####        ##    ##
##  ##          ##  ######  ####
##      ##  ##      ##          
################################
