################################
              ##              ##
##  ####  ####    ##########  ##
##  ##    ####  ##        ##  ##
##  ##  ##      ##  ####  ##  ##
##  ##  ########    ##    ##  ##
##  ##          ##  ##  ####  ##
##    ##  ##  ##    ######    ##
##  ##  ##        ##        ####
####        ##  ##    ##  ##  ##
####  ####    ##    ##  ##    ##
##    ##    ##    ##        ####
##  ##    ####  ##    ####    ##
##    ######        ##  ####  ##
####          ##  ##            
################################
