################################
          ##        ##        ##
##  ####      ####      ####  ##
##  ##  ####      ######      ##
##          ##  ##      ##  ####
##  ##  ##    ##    ##  ##    ##
##    ##    ##    ##  ##  ##  ##
##  ##    ##    ##            ##
####    ##  ##    ##  ####  ####
##    ####    ##  ##  ##  ##  ##
####      ##          ##      ##
##    ##    ####  ####    ##  ##
####    ##  ##          ##    ##
##  ##  ##  ##  ########  ##  ##
##      ##    ##                
################################
