################################
    ##        ##      ##  ##  ##
##    ####  ##    ##  ##      ##
####        ##  ##    ##  ##  ##
##    ##  ####  ##  ####  ##  ##
####    ####    ##  ##    ##  ##
##  ##        ##    ##  ##    ##
##    ##  ####    ##    ##  ####
####    ##      ##  ####      ##
##    ##    ####      ##  ##  ##
##  ##    ######  ##      ##  ##
##      ######    ######    ####
####  ######    ##      ##    ##
##      ##    ##    ####  ##  ##
##  ##      ######              
################################
