################################
    ####          ##      ##  ##
##        ##  ####    ##      ##
####  ##    ##      ########  ##
##    ##  ##    ##    ##      ##
####    ##    ##    ####  ##  ##
##  ##    ##  ##  ##      ##  ##
##    ##        ##    ##  ##  ##
##  ##  ####  ##    ##  ##    ##
##          ##    ##        ####
##  ##  ##      ##  ####  ##  ##
##  ##  ####  ####        ##  ##
##  ##    ####      ####      ##
##  ####      ######    ##  ####
##      ####          ##        
################################
