################################
          ##        ##      ####
####  ##    ##  ####    ##    ##
##  ######            ##    ####
##    ##    ####  ####    ##  ##
####  ##  ####    ######      ##
####    ##      ##  ##  ####  ##
##    ##    ####          ##  ##
####      ##  ##  ####  ##    ##
##  ####  ##      ####    ##  ##
##  ##  ##    ####    ##      ##
##      ##  ##      ##  ####  ##
####  ####    ####          ####
##    ##  ##      ##  ####    ##
####          ##          ##    
################################
