################################
              ##      ##      ##
##  ######  ##    ##    ####  ##
##  ##  ##    ##    ##    ##  ##
##      ####    ##  ####      ##
##  ####      ####      ####  ##
####      ##      ####    ##  ##
##    ##    ####  ##    ##    ##
####    ##    ####    ####  ####
####  ##    ##      ##        ##
##      ####    ##  ##  ##  ####
##  ####      ##    ##  ##    ##
##        ####  ######    ##  ##
##  ########          ##  ##  ##
##  ##        ##  ##      ##    
################################
