################################
    ####  ##          ##      ##
##          ####  ##  ##  ##  ##
####  ####        ##  ##  ##  ##
##    ##  ########    ##  ##  ##
##  ##            ##  ##  ##  ##
##  ####  ##  ##      ####    ##
##      ##      ######  ##  ####
##  ##  ######      ##      ####
##  ##        ####      ##    ##
##    ######  ########    ##  ##
####      ##    ##    ##    ####
##  ####  ####    ##    ##    ##
##  ##      ####    ##    ##  ##
##      ##      ##    ##        
################################
