################################
        ##            ######  ##
##  ##      ####  ##    ##    ##
##    ####  ##  ##  ##      ####
##  ##      ##        ####  ####
####    ####    ####    ##    ##
##    ##      ##      ##  ##  ##
####    ##  ####  ##  ##      ##
##  ##    ##      ####    ######
##    ##  ##  ##    ##  ##    ##
####      ##  ##  ##    ####  ##
##    ####      ##    ##      ##
####  ##    ##    ##  ##  ##  ##
##    ##  ##  ##  ##  ##  ##  ##
##  ##        ##          ##    
################################
