################################
    ####          ##      ##  ##
##        ##  ##      ##  ##  ##
##  ##  ##      ######    ##  ##
####    ##  ####    ##  ####  ##
##  ##  ##      ##            ##
##  ##  ######    ######  ##  ##
##  ##        ##        ##  ####
##  ########    ######        ##
##          ##        ##  ##  ##
##  ######    ########  ####  ##
####      ##                  ##
##    ##  ####  ##  ##  ##  ####
##  ####      ##  ##  ##      ##
##      ####              ##    
################################
