################################
          ##      ##          ##
##  ####      ####    ######  ##
##    ##########    ##    ##  ##
####              ##  ##      ##
####  ####  ##  ##    ######  ##
##        ##        ##      ####
##  ####    ####  ##    ##  ####
####    ##    ##    ######    ##
##    ##  ##  ##  ##      ##  ##
##  ##        ##      ##      ##
##    ##  ####  ######  ########
##  ##      ##                ##
##    ####  ############  ##  ##
####                      ##    
################################
