################################
                      ##      ##
##  ##  ##  ####  ##  ##  ##  ##
##  ######  ##    ##      ##  ##
####      ####  ##  ####  ##  ##
####  ##        ##      ##    ##
##      ##  ######  ##  ##  ####
##  ##    ##      ####        ##
##  ##  ####  ##      ##  ##  ##
##    ##      ######    ####  ##
####      ####      ##      ####
##    ######  ####    ####  ####
##  ##            ##    ##    ##
##    ####  ##  ##  ##  ####  ##
####        ##      ##          
################################
