################################
          ####  ##      ##    ##
##  ####        ##  ##      ####
##    ####  ##  ##    ##  ##  ##
####    ##    ##  ##  ##  ##  ##
##  ##    ##          ##      ##
##  ####  ########  ##  ####  ##
##    ##          ##      ##  ##
####    ########      ######  ##
##    ##        ##  ##        ##
##  ##    ####      ##  ####  ##
##      ##      ##  ##  ##    ##
##  ######  ######  ##  ##  ####
##  ##    ##      ##    ##  ####
##    ##      ##      ##        
################################
