################################
      ##    ##            ##  ##
##  ##    ##    ####  ##      ##
##  ##  ######  ##      ####  ##
##      ######  ##  ##    ##  ##
####  ##  ##    ##    ##    ####
##    ##      ##  ####  ##    ##
####    ##  ##            ##  ##
##  ##      ##  ####  ####    ##
##    ######  ##      ####  ####
##  ##            ####      ####
##      ########  ##    ####  ##
##  ####      ##  ##  ##      ##
##        ##    ##      ####  ##
##  ##  ######      ##          
################################
