################################
    ##      ##      ##  ##    ##
##  ######      ##          ####
##        ##########  ####    ##
##  ##  ##      ######      ####
##  ##      ##    ##    ####  ##
##  ####  ##  ##  ##  ##      ##
####      ##  ##  ##  ##  ##  ##
##    ####    ##  ##  ##  ##  ##
##  ##      ##    ##    ##    ##
##    ####      ##  ##      ####
####    ##  ##  ##    ####  ####
##  ##    ####    ##  ##      ##
##  ####      ####        ##  ##
##        ##        ##  ##      
################################
