################################
              ##          ##  ##
##  ####  ####    ######      ##
##  ######      ##    ######  ##
##    ##    ####    ##        ##
####      ######  ##    ########
##    ########      ####      ##
####  ##  ##    ######    ##  ##
##    ##      ##        ####  ##
####    ##  ##    ######      ##
##  ##  ##      ##    ##  ##  ##
##      ##  ##      ##    ##  ##
##  ########  ####  ####  ##  ##
##  ##  ##        ##      ##  ##
##          ####      ####      
################################
