################################
        ####  ##    ##        ##
##  ##          ##      ####  ##
##    ####  ##  ####  ##      ##
####    ##  ##    ##    ##  ####
####  ##      ##    ##  ##  ####
##    ##  ####  ##  ##  ##    ##
##  ####        ##  ##    ##  ##
##      ####  ##        ##    ##
##  ####  ##  ##########  ######
##        ##                  ##
####  ####  ##  ####  ##  ##  ##
####        ####    ##    ##  ##
##  ##  ##    ####    ######  ##
##        ##      ##            
################################
