################################
          ##  ####      ##  ####
##  ##  ##          ##  ##    ##
##    ##    ####  ####    ##  ##
####  ##  ##  ##  ##  ##  ##  ##
##    ##  ##  ##  ##      ##  ##
####          ##  ##  ##  ##  ##
############  ##  ####        ##
####        ##        ####  ####
##    ####  ##  ####    ##    ##
##  ####      ##  ####    ##  ##
##  ##    ##  ##      ##    ####
##  ######      ####    ##    ##
##        ##  ##      ####  ####
##  ##  ##        ##            
################################
