################################
          ##                  ##
########    ##  ##  ########  ##
##      ##    ##          ##  ##
##  ##  ####  ##  ########    ##
##  ##        ##  ##        ####
##  ##  ##  ##    ##  ######  ##
##    ##    ##  ##    ##      ##
####    ####      ##  ##  ######
##    ##      ####    ##      ##
##  ##    ####    ####    ##  ##
##    ##      ##        ####  ##
####    ####  ##  ######      ##
######    ##  ####        ##  ##
########            ##  ##      
################################
