################################
    ##  ##      ##  ##      ####
##          ##        ####    ##
##  ####  ##    ####  ######  ##
##    ##    ####  ##    ##    ##
####    ##  ##      ##    ##  ##
##    ##    ##  ##    ##  ##  ##
####    ##  ##    ##  ##  ##  ##
##    ##      ##    ####      ##
####  ##  ##    ##      ##  ####
##    ##  ##  ##  ##  ##      ##
####  ##    ##    ##    ####  ##
##    ##  ##    ##    ##      ##
####  ##      ##  ##  ##  ######
##      ##  ##                  
################################
