################################
          ##      ##        ####
##  ##  ##    ##  ####  ##    ##
####        ##        ##  ##  ##
##    ######  ##  ##  ##      ##
##  ##          ####  ##  ##  ##
##  ##  ######        ##  ##  ##
##  ##        ########    ##  ##
##  ##  ##  ##        ##    ####
####  ####    ##  ##  ####    ##
##        ##  ##  ##      ##  ##
##  ##  ####    ##  ##  ####  ##
##  ##      ##  ##      ##    ##
##  ####  ####  ######      ####
##    ##                ##      
################################
