################################
      ##                      ##
####      ##  ######  ######  ##
##    ####  ##      ##        ##
##  ##  ##    ####    ##########
##        ##        ##        ##
########    ##  ##  ####  ##  ##
##      ##  ##  ##        ##  ##
####  ####  ##    ##  ####    ##
##    ##        ##  ##      ####
####    ########    ##  ####  ##
##  ##            ##    ##    ##
##      ######  ####  ##  ##  ##
##  ######  ##        ##      ##
##            ##  ##      ##    
################################
