################################
    ##      ##            ##  ##
##      ##  ##  ####  ##  ##  ##
####  ##  ##    ##    ##      ##
##    ##      ##    ########  ##
##  ##    ########  ####      ##
##  ##  ##    ####      ####  ##
##      ####      ####  ##    ##
##  ####    ####    ##  ##  ####
##      ##      ##  ##    ##  ##
##  ##      ##        ##  ##  ##
##  ####  ##    ##  ##        ##
##    ##    ######    ######  ##
##  ##  ####      ####        ##
##  ##        ##        ####    
################################
