################################
      ##        ##    ##      ##
####      ####      ##    ##  ##
##########      ##  ##  ##    ##
####        ##    ##    ####  ##
##    ######    ####  ##      ##
##  ####      ##      ##  ######
##      ##  ##    ######  ##  ##
##  ##  ##  ##  ####      ##  ##
##  ##  ##  ##      ##  ##    ##
####    ##  ########        ####
####  ######        ######    ##
##    ####    ##  ##        ####
##  ##      ##    ##  ######  ##
##      ##    ##                
################################
