################################
    ##      ##  ##        ##  ##
##      ##          ####      ##
##  ##########  ##  ##    ##  ##
##      ##    ##  ##    ##    ##
######      ##      ##    ##  ##
##    ##  ##    ##  ####  ##  ##
####  ##  ##  ##        ##    ##
####      ##    ######  ##  ####
##    ####  ##  ##  ##      ####
####  ##        ##    ######  ##
##    ##  ######  ##      ##  ##
##  ##    ##  ##      ##      ##
##    ####      ##  ##  ####  ##
####        ##      ##          
################################
