################################
          ##      ######      ##
##  ##  ##    ##    ##    ##  ##
####        ####  ##    ####  ##
##    ########      ##  ##    ##
##  ##        ####  ##  ##  ####
##    ##  ##      ##    ##    ##
####      ##  ##  ##  ##  ##  ##
##    ####    ##  ####    ##  ##
##  ##      ####      ##  ##  ##
##  ##  ####    ####      ##  ##
##  ##  ##  ##    ####  ##    ##
##  ##        ##        ##  ####
##    ######    ########      ##
####        ##            ##    
################################
