################################
      ##  ##  ##  ##          ##
##  ##            ##  ####  ####
##      ##  ##  ##      ##    ##
##  ####      ####  ######  ####
##      ##  ##      ##        ##
##  ##  ##      ####    ####  ##
##    ##  ##  ##    ##      ####
####        ######    ######  ##
##  ##  ##    ##  ##  ##      ##
##    ##  ##      ##      ##  ##
##  ##      ##  ##    ##    ####
##      ##  ##    ########    ##
##  ######    ##      ##  ##  ##
##        ##      ##            
################################
