################################
        ##        ##        ####
##  ##  ##  ####      ####    ##
####    ##  ##    ##    ####  ##
##    ##    ##  ##  ####    ####
##  ##    ####        ##  ##  ##
##    ##      ######  ##  ##  ##
####      ##  ##      ##      ##
##    ####  ##    ####  ####  ##
####  ##        ##            ##
##    ##  ####  ##  ##  ########
##  ####      ##      ##      ##
##  ##    ##  ##  ##    ##  ####
####    ##      ##  ##      ####
##    ##    ##          ##      
################################
