################################
          ##            ##    ##
##  ####      ####  ##  ####  ##
##      ##  ##  ##  ##    ##  ##
######    ##    ##    ##      ##
##  ##  ##    ##  ##  ####  ####
##  ##  ##  ##          ##    ##
##  ##  ##    ########    ##  ##
##      ##  ##        ##  ##  ##
##  ####    ##  ##  ####  ##  ##
##    ##  ##    ##        ##  ##
####      ##  ##  ######    ####
##  ##  ##    ##        ##    ##
##  ##  ##  ##    ##  ##  ##  ##
##        ##    ##              
################################
