################################
    ##      ##      ##      ####
##      ##  ##  ##    ##  ##  ##
##  ####      ######  ##  ##  ##
##  ##    ##  ####    ##  ##  ##
##    ##  ##        ##    ##  ##
####    ##    ######  ##  ##  ##
##    ##    ##        ##      ##
##  ##    ##    ##  ##  ####  ##
##  ##  ##    ####      ####  ##
##    ##    ####    ####      ##
####      ##      ##      ######
##    ####    ########  ##    ##
####  ##  ##      ##        ####
##          ####      ####      
################################
