################################
    ##                ##      ##
##  ##  ########  ##    ##  ####
##  ##  ##    ##  ######      ##
##  ##  ####  ##          ##  ##
##  ##          ##  ##  ####  ##
##    ####  ##    ######      ##
##  ######  ####    ##    ##  ##
##    ##      ####  ##  ##  ####
##  ##    ##    ##  ##        ##
##  ##  ##  ####      ######  ##
##      ##      ####  ##      ##
##  ##  ##  ##    ##  ##  ##  ##
####    ##  ####    ####  ##  ##
##    ##        ##        ##    
################################
