################################
            ##                ##
##  ####  ##    ##  ##  ####  ##
##      ##    ##      ##  ##  ##
######  ##  ##  ####  ##  ##  ##
##  ##    ##          ##  ##  ##
##  ####    ##  ##  ####  ##  ##
##      ##  ##    ##      ##  ##
####  ####    ##  ##  ##  ##  ##
##    ##    ####      ##  ##  ##
##  ####  ##    ####    ####  ##
##        ##  ##      ##      ##
##  ##  ####      ##  ##  ##  ##
####        ######  ####  ##  ##
##    ####                ##    
################################
