################################
    ##        ##              ##
##      ####      ##  ######  ##
########      ##  ##      ##  ##
##      ##  ##      ####    ####
##  ####      ####  ##  ##    ##
##  ##    ##    ####      ##  ##
##  ##  ##  ####      ##      ##
##  ##  ##        ##    ########
##  ##    ##  ####    ##      ##
##    ######    ##  ##    ##  ##
####        ##  ####    ##    ##
##  ######  ##        ####  ####
##            ########      ####
##  ##  ####            ##      
################################
