################################
      ####              ##    ##
####        ##  ######      ####
##  ##  ##  ####      ####    ##
##  ##  ##    ##  ##  ######  ##
##      ##  ##    ##    ##    ##
##  ####  ##    ##  ##    ##  ##
##            ##      ##  ######
##  ##  ##  ##  ####          ##
####  ##  ##        ########  ##
##    ##      ####            ##
##  ##    ##  ########  ####  ##
##  ####  ##    ##    ##      ##
##      ##  ##    ##  ##  ######
##  ##          ##              
################################
