################################
      ##  ##  ##    ##      ####
##  ##          ##      ##    ##
##  ##  ######      ####    ####
##  ####      ######    ##    ##
##        ####    ####    ##  ##
##  ####        ##      ##    ##
##  ##########      ##      ####
##    ##      ######  ######  ##
####  ######  ##      ##      ##
####      ##      ##  ####  ####
##  ####  ####  ####    ##    ##
##  ####        ##  ##    ##  ##
##      ########      ##  ##  ##
##  ##            ##            
################################
