################################
    ####    ##      ##        ##
##        ##    ##      ####  ##
##  ##  ##    ##  ######  ##  ##
##  ##    ##  ##  ##      ##  ##
##  ####  ##  ##      ####    ##
##    ##  ####  ##  ##      ####
####  ##        ##    ##  ##  ##
####    ##  ##      ####      ##
##  ##    ##  ##  ####  ##  ####
##      ##    ##        ##    ##
##  ####    ##    ####  ##  ####
##      ##    ##    ##  ##    ##
####  ####  ##  ##    ####  ####
##                ##            
################################
