################################
    ##                  ##    ##
##      ####  ####  ##      ####
##  ####    ##      ######    ##
##      ##  ##  ####    ####  ##
####  ####  ##      ##        ##
##          ##  ####    ##  ####
##  ########        ####    ####
####        ##  ##      ##    ##
##    ####  ####    ##  ####  ##
##  ##          ####      ######
##  ##########      ####      ##
##            ####      ####  ##
##  ########  ####  ####      ##
##          ##            ##    
################################
