################################
        ##          ##      ####
##  ##    ####  ####    ##    ##
####  ##          ##  ##  ##  ##
##      ####  ##  ##  ##      ##
##  ##        ####      ########
##    ##  ##    ##  ####      ##
##  ##    ####  ##  ##    ##  ##
##    ##      ####  ##  ####  ##
####    ######        ##      ##
##    ##        ######    ##  ##
##  ####  ######        ##    ##
##  ##    ##      ######    ####
##  ##  ##    ####    ##  ##  ##
##          ########            
################################
