################################
          ##              ##  ##
##  ####    ##  ######  ##    ##
##  ######          ##      ####
##    ##  ########    ####  ####
######            ##  ##      ##
##      ########  ##    ####  ##
##  ####      ##    ##  ##    ##
##  ##    ####    ##    ########
##  ####  ####  ##  ##        ##
##    ##        ##  ##  ####  ##
####  ##  ##  ##      ######  ##
##  ##    ####    ##    ##    ##
##  ##  ##      ##  ##  ##  ####
##          ####                
################################
