################################
            ##        ##      ##
##  ####  ##    ####      ##  ##
##  ##    ####      ######    ##
##    ##      ##  ####      ####
####  ##  ##  ####      ##  ####
##    ####      ##  ######    ##
##  ##      ##      ##    ##  ##
##  ##  ####  ##########      ##
##  ##  ##          ##  ########
##  ##  ####  ####            ##
##  ##      ##  ############  ##
##  ########              ##  ##
##        ##  ######  ######  ##
##  ####          ##            
################################
