################################
    ##            ##          ##
##  ##  ##  ####      ######  ##
##  ##    ##    ##  ####  ##  ##
##  ####  ####    ##      ##  ##
##          ##  ##    ####    ##
##  ##  ##          ##      ####
##    ##  ######  ##    ##    ##
##  ##          ##    ######  ##
####    ##  ##      ##  ####  ##
##    ##  ####  ####        ####
##  ##        ##      ####    ##
##    ##  ##      ####    ##  ##
####        ######  ##  ####  ##
##    ####              ##      
################################
