################################
    ##  ##    ####  ##      ####
##        ##            ##    ##
##  ####    ##  ##  ##  ########
##  ##  ####    ##    ##      ##
##        ####  ####  ##  ##  ##
####  ##    ##      ##    ##  ##
##      ####    ##      ##    ##
##  ##      ##    ########  ####
####  ####  ####  ##          ##
##      ##      ##    ####  ####
##  ##    ####    ##  ##      ##
##    ####  ##  ##    ##  ##  ##
##  ##      ##  ##  ##  ####  ##
##      ##          ##          
################################
