################################
    ####          ##          ##
##        ######    ##  ####  ##
####  ####      ####      ##  ##
##    ##    ##    ##  ##    ####
##  ##    ##  ##      ####    ##
##  ####  ##    ######  ##  ####
##          ##  ##      ##    ##
##  ##  ##        ####    ##  ##
##    ##  ##  ##        ##    ##
##  ##      ##    ##  ##    ####
##      ####  ##    ##    ##  ##
##  ##  ##    ##  ####  ##    ##
####    ##  ##  ##          ####
##    ##            ##  ##      
################################
