################################
      ####  ##              ####
##  ##        ##  ########    ##
##    ##  ##  ##          ##  ##
####  ##  ##    ########  ##  ##
####      ##  ##      ####    ##
##  ########      ##        ####
##          ######  ######  ####
##  ##  ##          ##        ##
##  ########  ##  ##    ####  ##
##      ##      ##    ##    ####
##  ##  ##  ##    ##    ##    ##
##  ##  ##  ######  ##    ##  ##
##  ##    ##          ##  ##  ##
##    ##      ##  ##            
################################
