################################
      ####    ##      ##      ##
##  ##    ##      ##    ####  ##
##      ##  ##  ##  ##        ##
####  ####      ##    ##  ##  ##
##    ##    ##    ##    ##    ##
##  ##    ####  ######  ##  ####
##    ####      ####    ##    ##
####  ##    ####      ######  ##
####      ##    ##  ##  ##    ##
##  ######    ##            ####
##        ##      ######  ##  ##
##  ##  ##    ####      ##    ##
##    ####  ##      ##      ####
####            ####    ##      
################################
