################################
    ##        ##        ##    ##
##      ########  ####  ##  ####
####  ##          ##    ##    ##
##    ##  ####  ##    ##  ##  ##
##  ##    ##  ####  ##        ##
##    ##  ##        ##  ##  ####
##  ##  ##    ######  ####    ##
##  ##      ##              ####
##  ##  ####  ##  ########    ##
##  ##  ##        ##    ####  ##
##  ##  ########    ##        ##
##  ##        ##  ##    ########
##  ####  ##      ##  ##      ##
##          ##  ##        ##    
################################
