################################
              ######      ##  ##
##  ####  ##    ##  ####  ##  ##
##  ##    ####        ##      ##
####    ##    ##  ##    ####  ##
##    ####  ##    ######      ##
##  ####    ##  ##        ######
##  ##    ##        ##  ####  ##
##  ##  ##  ##  ####  ##      ##
##  ##        ####      ##  ####
##  ##  ####        ##      ####
##  ##      ######    ####    ##
##  ##  ####      ##    ####  ##
##  ####      ##    ####      ##
##        ##    ##        ##    
################################
