################################
              ####        ##  ##
########  ##        ######    ##
##        ####  ##  ##      ####
##  ######      ####    ####  ##
##        ######      ##      ##
##  ####          ####    ##  ##
##      ##  ########    ##    ##
##  ####  ##          ####  ####
##          ##  ##  ##      ####
##########  ##  ##    ##  ##  ##
##      ##  ######  ##        ##
####  ####          ##  ####  ##
####      ##########  ##      ##
##    ##                  ##    
################################
