################################
        ##      ####          ##
##  ##      ####    ##  ####  ##
##    ##  ##      ##    ##    ##
##  ##    ##  ########  ##  ####
##  ##  ##    ##  ##      ##  ##
##  ##      ##      ####      ##
##  ##  ####    ##      ####  ##
####    ##  ##    ####  ##    ##
##    ##        ##  ##  ##  ####
##  ####  ######        ##  ####
##        ##      ########    ##
####  ####  ##  ##        ##  ##
##  ##              ####  ##  ##
##      ##  ####  ##            
################################
