################################
    ##        ##              ##
##  ##  ####    ##  ##  ####  ##
##      ##  ##  ##  ##      ####
##  ####        ##    ####    ##
##    ##  ##  ##    ####  ##  ##
########    ##    ##      ##  ##
##        ##    ##    ##  ##  ##
##  ######    ##  ##    ##    ##
##          ##      ##      ####
##  ########  ##  ##########  ##
##  ##            ####        ##
##      ########        ####  ##
########        ########  ##  ##
##        ####                  
################################
