################################
            ####        ##    ##
####  ####        ####    ##  ##
##    ############    ##      ##
####    ##        ##    ####  ##
######    ######    ##        ##
####    ##      ##  ##  ########
##    ##    ##  ##      ##    ##
##  ##    ####  ##  ####    ####
##  ##  ##      ##    ####    ##
##  ##    ##  ######        ####
##      ####    ##  ######  ####
########    ####        ##    ##
##      ##  ##  ##  ####  ##  ##
##  ##                          
################################
