################################
    ####    ##        ####    ##
##        ##  ##  ##        ####
##  ##  ##      ##    ##  ##  ##
####    ##  ##  ####  ##      ##
##    ##    ##      ####  ##  ##
####    ##    ####      ####  ##
##  ##      ##    ####        ##
##    ##  ##    ##  ########  ##
##  ######    ##          ##  ##
##  ####    ##    ####  ##    ##
##        ######    ##      ####
##  ##  ##  ##    ##  ##  ##  ##
##  ##  ##  ##  ##      ####  ##
##  ##              ##          
################################
