################################
            ##              ####
####  ####  ##  ######  ##    ##
##      ##      ##  ##    ##  ##
####  ##  ######      ##    ####
##            ##  ##    ##    ##
############      ####    ##  ##
##          ####    ######    ##
##  ######      ####      ##  ##
##        ####        ##      ##
######  ##    ##############  ##
##      ##  ##        ##      ##
##  ##  ##  ##  ####  ##  ##  ##
##    ##    ##  ##  ##      ####
####      ##            ##      
################################
