################################
    ####                      ##
##        ####  ##  ####  ##  ##
####  ####    ##    ##  ####  ##
##    ##    ##    ####        ##
####      ######  ##    ########
##  ####    ##    ##  ####    ##
##    ####  ##  ##    ##    ####
##  ##      ##    ##  ##  ######
##  ##  ########  ##  ##    ####
##          ##    ##    ##    ##
##  ####  ##    ####  ######  ##
##      ##    ####      ##    ##
######  ##  ####    ##    ##  ##
##      ##  ##    ######        
################################
