################################
      ##      ##        ##    ##
##  ##    ####    ####      ####
##      ##      ##    ##  ##  ##
##  ##  ##  ####    ####      ##
##    ##    ##  ##      ##  ####
####  ##  ##        ##  ##  ####
##    ##  ##  ########  ##    ##
##  ##    ##  ##          ##  ##
##    ##  ##  ##  ######  ##  ##
##  ####  ####    ##    ####  ##
##  ##      ##  ##    ##      ##
##      ####      ##  ####  ####
####  ##      ##  ##        ####
##        ####      ##  ##      
################################
