################################
                              ##
##  ######  ######  ##  ####  ##
##        ##      ####    ##  ##
####  ##  ######      ##  ######
##  ##        ######  ##      ##
##  ##  ##  ##        ##  ##  ##
##  ##    ##    ##  ##    ##  ##
##    ##    ##    ##    ####  ##
####  ##  ##    ##    ##      ##
##    ##    ##    ####    ##  ##
##  ##  ##    ##  ##    ##  ####
##  ##    ##  ##    ##        ##
##      ####  ####    ######  ##
##  ##            ##            
################################
