################################
    ##        ##          ##  ##
##      ####    ####  ##      ##
##  ####  ####        ##  ##  ##
##  ##        ##########    ####
##  ######  ##          ##    ##
##      ##    ####  ##    ##  ##
##  ##    ##    ##  ######    ##
##  ##  ##  ##              ####
##  ##        ##  ######  ##  ##
##    ######    ##      ####  ##
##  ####    ##      ##  ##    ##
##        ##  ####  ##      ####
####  ####        ##  ####  ####
##          ####        ##      
################################
