################################
      ##      ##    ##      ####
####  ##  ##    ##      ##    ##
##    ##    ##  ##  ##    ##  ##
##  ##    ##  ##      ##  ##  ##
##      ##        ####    ##  ##
##  ####  ##  ##    ##  ##    ##
##    ##    ##    ##    ##  ####
####    ##      ##    ##      ##
##  ##  ##  ####  ##  ##  ##  ##
##  ##  ##    ##  ##    ##  ####
##      ####        ##        ##
##  ####    ######    ######  ##
##    ##  ##      ####        ##
####          ##        ####    
################################
