################################
      ##  ####    ####        ##
##  ##          ##      ##  ####
##      ##  ##    ######      ##
##  ####      ##      ##  ##  ##
##      ####    ####    ####  ##
##  ##      ##  ##    ##      ##
##    ##  ##      ####    ######
######  ####  ####      ##    ##
##            ##    ####    ####
##  ##########    ##      ##  ##
##  ##          ####  ##      ##
##  ##  ##  ####      ######  ##
##        ##      ####    ##  ##
##  ####      ##      ##        
################################
