################################
        ######        ##  ##  ##
##  ##    ##    ####          ##
##    ####    ##    ##  ##  ####
##  ##    ##  ##  ######      ##
##    ##  ##      ####    ##  ##
##  ##      ##  ##      ####  ##
##  ##  ######  ##  ####      ##
##  ##          ##    ##  ######
##    ######  ##    ##    ##  ##
##  ##      ##  ##  ####      ##
##  ##  ##      ##      ####  ##
##  ##    ####  ######  ##    ##
##    ##  ##            ##  ####
####      ##  ##  ##  ##        
################################
