################################
                ####          ##
##  ####  ##  ##      ######  ##
##    ##  ##  ##  ##  ##      ##
##  ##    ####      ##    ######
##  ##  ##      ####    ##    ##
####    ##  ##    ##  ##    ####
####  ##    ##  ##    ##  ##  ##
##    ##  ##  ##  ####    ##  ##
##  ####            ####      ##
##  ##  ##########    ####  ####
##                ##        ####
##  ########  ##    ######    ##
##  ##      ##  ##      ####  ##
##      ##        ####          
################################
