################################
              ##    ##      ####
##  ##  ####      ##    ##    ##
##    ##    ####      ##  ##  ##
####    ##        ####    ##  ##
##    ##    ########    ####  ##
####  ##  ##        ##        ##
##    ##    ##  ##    ##  ##  ##
######    ####    ##    ########
##      ####    ##  ##  ####  ##
##  ####      ##    ##        ##
##  ##    ####    ##  ##########
##  ##  ##      ##            ##
##  ##  ##  ##  ########  ##  ##
##          ##            ##    
################################
