################################
    ##      ####      ####    ##
##      ##        ##        ####
##  ##  ######  ######  ##    ##
####        ##    ##  ######  ##
##    ####    ##        ##    ##
##  ##  ####    ##  ##    ##  ##
##  ##      ##    ##  ##    ####
####    ##    ##      ####    ##
##    ##  ##  ##  ##      ##  ##
##  ####      ##    ##  ##    ##
##      ######  ##    ##    ####
####  ##          ####    ##  ##
##      ####  ##  ####  ####  ##
##  ##        ##                
################################
