################################
    ##  ##                  ####
##        ##  ##  ########    ##
##  ####  ##  ##  ##      ##  ##
##    ##  ######      ##  ##  ##
####  ##        ##  ##    ##  ##
####    ######  ####    ##    ##
##  ##      ##      ##  ########
##  ########  ####  ##        ##
##            ##    ##  ####  ##
####  ##  ######  ##    ##    ##
####    ##        ####    ##  ##
##    ##    ##  ##      ####  ##
##  ##    ##      ######      ##
##      ##    ##          ##    
################################
