################################
      ##              ##########
####      ##  ##  ##    ########
##    ##  ##    ##  ##    ######
##  ##      ##  ##    ##    ####
####    ####    ##  ##  ##    ##
##    ####    ##          ##  ##
##  ##      ##  ##  ########  ##
##  ####  ##                  ##
####      ##  ####  ############
##    ####        ##          ##
##  ####    ####    ##  ####  ##
##      ####    ##    ####    ##
##  ##  ##    ####  ##      ####
##  ##      ##          ##      
################################
