################################
          ##              ##  ##
##  ####      ##  ######      ##
##    ##  ####  ##      ####  ##
####    ##        ##  ####    ##
######      ####  ##  ##    ####
####  ##  ##      ##      ######
##      ##    ##    ##  ########
######  ##  ##  ##    ##  ######
##  ##    ####    ##        ####
##      ##      ##  ##  ##    ##
####  ####  ##        ##  ##  ##
##    ##    ####  ##          ##
##  ##    ##    ##  ########  ##
##      ######                  
################################
