################################
            ##              ####
##  ####  ##    ##  ##  ##    ##
##    ######  ##  ##    ##  ####
####              ##  ####    ##
##    ##  ########    ##  ##  ##
######  ##          ##    ##  ##
##          ####  ##    ##    ##
##  ####  ##    ##  ##      ####
##  ##  ######      ##  ####  ##
##        ##    ##  ##  ##    ##
####  ##    ##  ##      ####  ##
##    ####  ##    ##  ##      ##
##  ##  ##    ##    ##    ##  ##
##        ##    ##      ##      
################################
