################################
    ##        ##              ##
##      ####  ##  ##  ####  ####
##  ######    ##  ##  ##      ##
####        ####  ##    ####  ##
####  ####  ##    ####      ####
##    ##    ##  ##    ####    ##
##  ####  ####  ####      ##  ##
##      ##          ##  ##    ##
##  ##  ##  ##  ##  ##  ##  ####
##  ##      ####        ##    ##
##  ####  ##    ##  ##    ##  ##
##      ##    ##  ####  ##    ##
######  ##  ####      ####  ####
##      ##        ##            
################################
