################################
        ##########      ##  ####
##  ##    ######    ##  ##    ##
##    ##    ##    ####    ##  ##
##  ##  ##  ##  ##    ##      ##
##        ##    ####    ####  ##
##  ######    ##      ##      ##
##        ####    ##    ##  ####
##  ##  ##    ##  ####  ##    ##
##  ##      ##      ####  ##  ##
##    ####      ##        ##  ##
####      ##  ##  ######  ##  ##
####  ##    ##    ##  ##      ##
##      ##    ##      ##########
##  ##    ##      ##            
################################
