################################
    ##  ##          ####      ##
##          ######        ##  ##
##  ########    ##########    ##
##  ##      ##            ##  ##
##    ####    ##  ##  ##      ##
########  ##    ##    ######  ##
##          ##  ##  ##      ####
####  ########  ##      ##    ##
####              ######  ##  ##
##    ####  ##  ####          ##
##  ##  ##    ##      ##########
##  ##    ##      ######      ##
##      ##  ######        ##  ##
##  ##              ##  ##      
################################
