################################
    ##          ##  ##        ##
##      ##  ####        ####  ##
##  ##  ##  ##    ####    ##  ##
####  ####      ##    ##  ##  ##
##        ####      ##    ##  ##
##  ####      ##  ##    ##    ##
##  ##  ####    ##    ##    ####
##  ##      ##  ####  ##  ######
##  ##  ####          ##  ######
##  ##  ####  ##########    ####
##  ##        ##        ##    ##
##    ##  ####    ####  ####  ##
####    ##  ##  ##    ##  ##  ##
######            ##            
################################
