################################
            ####    ##        ##
####  ##  ##    ##      ####  ##
##      ##    ######  ######  ##
####  ##    ##  ##      ##    ##
##        ##      ####  ####  ##
##  ########  ##    ##      ####
##  ##      ##  ##      ##  ####
##      ##      ##  ######    ##
####  ##  ####    ##      ##  ##
##  ##        ##  ##  ##  ##  ##
##      ####  ##      ##      ##
##  ####        ######  ####  ##
##    ##  ########      ####  ##
####  ##            ##          
################################
