################################
      ##    ##          ##  ####
####      ##    ##  ##        ##
####  ##    ##    ##  ##  ##  ##
##    ####      ##      ##    ##
####    ######  ##  ##      ####
##  ##        ##    ######    ##
##  ####  ##  ##  ##      ##  ##
##          ##        ##  ##  ##
####  ##  ##  ##  ####      ####
##    ##  ##  ##      ####    ##
####    ##    ##  ##      ##  ##
##  ##    ##  ##    ######    ##
##    ##  ##  ######      ##  ##
####      ##          ##        
################################
