################################
    ##      ##      ##        ##
##      ##    ####      ####  ##
##  ####  ##    ####  ####    ##
##    ##      ##      ##    ####
####    ##  ##    ####    ##  ##
##  ##    ##    ####    ##    ##
##      ####  ##      ##  ##  ##
##  ##        ##########  ##  ##
##    ##  ####                ##
####    ##  ####  ##########  ##
##  ##  ##        ##          ##
##      ####  ####  ##  ##  ####
##  ####      ##    ##  ####  ##
##        ##    ##              
################################
