################################
      ####    ##      ##      ##
####        ##    ##      ##  ##
##  ##  ####  ##    ##  ##    ##
##      ##        ##    ########
##  ##  ##  ######  ##        ##
####    ##  ##        ##  ##  ##
####  ##    ##  ####    ####  ##
##    ##  ##        ####      ##
##  ####      ##  ##      ######
##      ######      ######    ##
##  ##  ##  ##  ####      ##  ##
##    ##        ##    ##      ##
####      ######    ##  ####  ##
##    ##          ##            
################################
