################################
      ######                  ##
####    ##    ##  ##  ##  ##  ##
######  ##  ####    ##  ##    ##
####        ##  ##        ##  ##
##    ##  ####    ######  ##  ##
####    ##      ##    ##  ##  ##
##  ##  ##  ##  ####  ##  ##  ##
##      ##  ##        ##  ##  ##
##  ######    ####  ##    ######
##        ##    ##  ##  ##    ##
####  ##    ##    ##      ##  ##
##  ##    ####  ##    ####    ##
##  ##  ##      ##  ##  ##  ####
##          ##  ##              
################################
