################################
    ##            ##          ##
##  ##  ####  ##      ##  ##  ##
##  ##  ####    ####  ######  ##
##  ##      ##    ####      ####
##      ####  ##        ##  ####
##  ####        ##########    ##
##        ##  ##          ##  ##
####  ##    ##    ##  ##  ##  ##
##  ##  ##    ##    ##        ##
##          ##  ##  ##  ####  ##
##  ####  ##    ##    ##    ####
##      ######  ##  ####  ##  ##
##  ##    ##    ##  ##        ##
##    ##      ##        ####    
################################
