################################
                ##          ####
##  ##  ######      ######    ##
##    ##      ########    ##  ##
####  ##  ##            ##    ##
##    ##    ######  ##  ##  ####
####    ##      ##    ####    ##
##    ##    ####  ##      ##  ##
##  ##    ##      ######  ##  ##
##  ######    ##          ##  ##
##          ##    ########    ##
########  ##    ##          ####
##      ##    ##    ######    ##
##  ####    ##    ##      ##  ##
##        ##    ##    ##        
################################
