################################
            ##                ##
##  ######  ##  ##########  ####
##  ##      ##  ##            ##
##  ##  ##    ####  ####  ##  ##
##  ####  ##        ##      ####
##          ####  ##    ##    ##
##  ####  ##        ####  ##  ##
##  ##      ########        ####
##    ####            ######  ##
####      ##########  ##      ##
######  ##          ##    ##  ##
######  ####  ##  ##    ##    ##
####        ####      ####  ####
##    ####        ####          
################################
