################################
            ##    ####        ##
##  ##  ##    ##        ########
######  ##  ##    ##  ##      ##
##      ##  ##  ##  ##  ####  ##
##  ##    ##    ##            ##
##  ##  ##    ####  ########  ##
##  ##  ##  ####    ##    ##  ##
##    ##          ##  ##  ##  ##
####    ##########    ##  ##  ##
##    ##          ##      ##  ##
##  ##    ##  ##      ####    ##
##      ##    ##  ####  ##  ####
##  ####  ##    ##      ##  ####
##          ##      ##          
################################
