################################
                  ##      ##  ##
##  ######  ######    ##  ##  ##
##  ##  ##          ##  ####  ##
##        ####  ####          ##
######  ##    ##      ##########
##  ##    ##      ####        ##
##    ##    ##  ##      ####  ##
####    ##  ##      ######    ##
######  ##    ##  ##        ####
######    ##    ####  ####    ##
####    ##    ##      ######  ##
##    ##    ##    ####  ##    ##
##  ##  ##  ##  ##        ##  ##
##              ##  ####        
################################
