################################
              ##    ####  ##  ##
####  ######    ##            ##
##          ####    ##  ####  ##
##  ######  ##    ##    ####  ##
##      ##  ##  ##    ##      ##
####  ##        ##  ##  ########
##      ######  ##  ##        ##
##  ####      ####      ####  ##
##    ##  ##      ########    ##
##  ####    ####            ####
##      ##  ##  ##########    ##
####  ##    ##  ##          ####
##  ####  ##    ##  ########  ##
##          ##                  
################################
