################################
                ##            ##
##  ############    ##  ####  ##
##  ##            ##      ##  ##
##      ####  ####  ####    ####
##  ####    ##          ####  ##
##    ####  ##  ####  ##  ##  ##
####    ##      ####          ##
##  ##  ##  ##      ##  ####  ##
##      ##    ######    ##    ##
##  ####    ##      ##  ##  ####
##      ##  ##  ##    ##      ##
##  ##    ##      ##  ##  ##  ##
##    ##      ####      ####  ##
####    ##  ##      ##          
################################
