################################
    ##        ##  ####      ####
##      ####  ##        ##    ##
####  ##  ##    ############  ##
##    ##    ##  ##      ##    ##
####  ####      ##  ##    ##  ##
##        ####      ##  ##    ##
####  ##  ##  ##  ####      ####
##    ##  ##    ##    ####    ##
##  ##    ####  ##  ##    ##  ##
####    ##      ##      ##    ##
##    ####  ######  ##  ##  ####
##  ##      ##      ##  ##    ##
##  ##  ####  ##  ##  ##  ##  ##
##      ##                      
################################
