################################
                          ##  ##
##  ######  ##  ##  ##  ##    ##
##        ##  ####    ##  ##  ##
########  ##        ##        ##
##        ##  ######    ########
##  ####    ####      ##      ##
##  ##    ##      ##    ##  ####
##    ####    ####  ####      ##
####    ##  ##            ##  ##
##    ##    ##  ##  ######    ##
##  ##    ##  ##        ##  ####
##      ##      ##########    ##
##  ######  ##            ##  ##
##            ##  ##  ##        
################################
