################################
        ##        ##      ##  ##
##  ##      ####      ##  ##  ##
##    ######    ######    ##  ##
####        ##        ##  ##  ##
##    ##  ##    ##  ##    ##  ##
##  ##    ##  ##    ##  ##    ##
######  ##  ##    ####      ####
##      ##    ##      ####    ##
##  ##    ##      ##        ####
##    ######  ##  ####  ####  ##
####        ##        ##      ##
####  ####    ##  ##  ##  ##  ##
##      ####  ####  ##      ####
##  ##    ##            ##      
################################
