################################
      ##  ##    ##      ##    ##
####          ####  ##      ####
######  ####          ##  ##  ##
####    ##  ##########        ##
##    ##            ##  ####  ##
##  ##    ########  ##  ##    ##
##  ##  ##        ##    ####  ##
##      ##  ####      ##      ##
####  ##    ##  ####    ####  ##
##    ##  ##        ####    ####
##  ##    ##  ##  ##      ##  ##
##  ##  ##    ##      ####    ##
##  ##    ##  ########      ####
##    ##                ##      
################################
