################################
      ##  ##  ##      ##      ##
##  ####  ##      ##  ##  ##  ##
##          ##  ##    ####    ##
##  ########      ##        ####
##  ##        ##    ##  ##    ##
##  ####  ##  ##  ##      ##  ##
##      ##    ##  ######    ####
######    ##  ##        ##    ##
##    ##    ##    ####  ####  ##
####  ####  ####    ##    ##  ##
##      ##      ##    ##  ##  ##
##  ##  ##  ##  ####  ##  ##  ##
##  ##    ##      ######  ##  ##
##    ##      ##          ##    
################################
