################################
          ##            ##    ##
##  ##  ####  ##  ####    ##  ##
##  ##        ##  ##    ##    ##
##    ##  ####    ##  ##    ####
####  ####      ##        ##  ##
##      ##  ##  ##  ##  ####  ##
##  ####    ####    ####      ##
##  ##    ##      ##  ##  ##  ##
####    ####  ####      ##    ##
##    ##        ######  ##  ####
####  ########          ##  ####
####          ##  ######      ##
##    ##  ##  ####      ##  ####
##  ##    ##        ##          
################################
