################################
      ####      ##      ##    ##
##  ##    ##  ##    ##    ##  ##
##    ##          ##    ####  ##
##  ##  ##  ####  ##  ##      ##
##        ##    ##    ####  ####
####  ####    ####  ##        ##
##    ##    ##      ####  ##  ##
##  ##    ####  ####      ##  ##
##      ####      ##  ####    ##
##  ####      ####    ##    ####
##  ##    ####      ##    ##  ##
##      ##      ####    ####  ##
##  ####    ####  ##  ##      ##
##        ##              ##    
################################
