################################
    ##  ##          ##        ##
##        ##  ####  ####  ##  ##
##  ####        ##        ##  ##
##  ##    ####  ####  ####    ##
####    ##  ##      ##      ####
##    ##      ####    ##  ##  ##
##  ##    ##      ##  ##  ##  ##
##    ##  ##  ####    ##      ##
##  ####    ##      ##  ####  ##
##      ##  ##  ####      ##  ##
######  ##  ##  ##    ####    ##
##  ##  ##  ##  ####        ####
##  ##  ##  ##      ##  ##  ####
##            ####    ##        
################################
