################################
                        ##    ##
##  ##  ####  ########  ##  ####
####    ##    ##    ##  ##    ##
##    ##    ######          ####
##  ####  ##  ##    ########  ##
####      ##      ##          ##
##    ##  ####  ##    ######  ##
##  ######    ######  ##      ##
##  ####  ##    ####  ##  ##  ##
##          ##        ####    ##
##  ##  ##    ########      ####
##  ##  ######        ##  ######
##  ##        ##  ####      ####
##    ##  ##            ##      
################################
