################################
      ##  ##      ####        ##
####          ####    ##  ######
####  ######      ##  ##      ##
##    ##    ####  ##  ##  ##  ##
##  ######    ##  ##  ##  ##  ##
##    ##  ##  ##  ##    ####  ##
####      ##  ##    ##        ##
##  ####  ##    ##    ##  ##  ##
##  ####      ##  ##    ####  ##
##      ##  ##    ##  ##      ##
##  ##          ####      ######
####    ##  ##  ##  ##  ##    ##
##    ##      ##      ##  ##  ##
##  ##    ##      ##            
################################
