################################
    ##        ##          ##  ##
##      ######  ##  ####      ##
##  ####          ##      ##  ##
##  ########  ##  ##  ######  ##
##    ##      ##      ##      ##
####  ##  ############    ######
####  ##      ##        ####  ##
##    ##  ##  ##  ######      ##
####    ##    ##        ##  ####
##    ##    ##  ######  ##    ##
####      ##    ##      ##  ####
##  ##  ##  ##      ####      ##
##    ####      ######  ####  ##
####        ##                  
################################
