################################
      ##  ##          ##      ##
####        ##  ##  ####  ##  ##
##    ####      ##        ##  ##
####    ##  ############  ##  ##
##  ##    ####  ##      ##  ####
##    ##            ##        ##
##  ##  ####  ######  ####  ####
##          ##          ##    ##
####  ##  ##    ##  ####    ####
####  ##  ##  ##    ##    ##  ##
##    ####      ##      ##    ##
##  ##      ##    ##  ##  ##  ##
##  ##  ####  ##    ####      ##
##              ##        ##    
################################
