################################
    ##  ##          ##        ##
##        ####  ##    ####  ####
##  ####  ##    ####    ##    ##
##  ##        ##      ##    ####
##    ####  ##    ##      ##  ##
####      ####  ##  ####      ##
####  ##      ####      ####  ##
##      ####      ####  ##    ##
##  ##      ####  ##      ##  ##
####  ##  ##  ##    ####  ##  ##
####    ##      ##  ##    ##  ##
##  ##  ##  ##  ##    ##  ##  ##
##          ##      ####      ##
##  ##  ##    ##  ##      ##    
################################
