################################
      ##  ##      ####  ##    ##
##  ##      ####        ####  ##
##      ##        ######      ##
##  ####  ########      ##  ####
##  ####        ##  ##      ####
##        ##  ##    ######    ##
########    ##    ##      ##  ##
##      ##  ##  ##    ##      ##
######  ##  ##    ##  ######  ##
##      ##    ##  ##        ####
##  ########  ##    ##  ##    ##
##      ##    ########  ####  ##
##  ##  ##  ##        ##      ##
##  ##          ####      ##    
################################
