################################
                ##            ##
####  ##  ####  ##  ####  ######
##    ##  ##    ##  ##        ##
##  ##      ##  ##    ######  ##
##    ####  ##    ##      ##  ##
######        ##  ##  ####    ##
##      ####  ##    ##      ####
##  ####    ##    ####  ##  ####
##  ##    ####  ##      ##    ##
##    ##            ##    ##  ##
##  ##    ##  ####  ####    ####
##    ####  ##        ####    ##
####          ########  ##  ####
##    ##  ##            ##      
################################
