################################
        ####                  ##
####  ##      ########  ####  ##
##        ######      ##      ##
##  ######        ##    ####  ##
##  ##      ##########  ##    ##
####    ####      ##        ####
##    ##      ##      ##  ######
##  ##    ######  ####      ####
##  ##  ##      ####    ##    ##
##    ####  ##  ##    ##    ####
##  ##      ##  ##  ##    ##  ##
##      ####      ##    ####  ##
##  ####    ########  ##      ##
##      ##                ##    
################################
