################################
          ##  ##    ##      ####
####  ##        ##      ##    ##
##    ####  ##    ##  ######  ##
##  ##  ##  ##  ##    ####  ####
##  ##    ##    ##  ##      ####
##    ##  ##  ##    ##  ####  ##
##  ####  ##  ##  ##    ##    ##
##  ##    ##  ##  ##  ##    ####
##  ##  ##        ##      ######
##  ##      ##  ##  ####    ####
##  ####  ######        ##    ##
##      ########  ##  ##  ##  ##
##  ##    ####    ##      ##  ##
##    ##        ##    ##        
################################
