################################
      ##  ######          ######
##  ##      ##    ##  ##    ####
##  ##  ##  ##  ##    ####    ##
##  ##  ##  ####  ##    ####  ##
##      ##          ####      ##
####  ##  ########  ##    ##  ##
##    ##          ##    ##    ##
##  ##    ##  ##      ##    ####
##    ##  ####  ####  ##  ##  ##
####  ##        ####    ##    ##
##    ########      ##  ####  ##
##  ##      ##  ##  ##        ##
##  ##  ##    ##  ##  ##  ##  ##
##        ##              ##    
################################
