################################
      ##      ##  ####        ##
####      ##            ####  ##
##    ####  ######  ####  ##  ##
##  ######      ##  ##      ####
##    ##    ##  ##      ##    ##
####    ####      ######    ####
######        ####      ##    ##
####  ##  ####  ##  ##    ##  ##
##      ##          ####      ##
##  ####    ########    ####  ##
##  ##    ##        ##        ##
##      ######  ##    ##  ######
####  ##  ##      ####        ##
######        ##        ####    
################################
