################################
            ##      ##      ####
####  ####  ##  ##  ##  ##    ##
##      ##      ##  ##    ######
##  ##    ##  ##      ##      ##
######  ##  ######  ##    ##  ##
##      ##    ##    ##  ##    ##
##  ####  ##      ##  ##    ####
##  ##    ##  ##        ##  ####
##  ##  ##    ##  ####  ##    ##
##  ##    ##    ##  ##    ##  ##
##  ####      ##    ####  ##  ##
##    ##  ####    ##  ##  ##  ##
####  ####      ##    ##  ##  ##
##          ##    ##            
################################
