################################
          ####      ##      ####
########        ##  ##  ##    ##
##      ##  ####    ##  ####  ##
##  ##      ##    ##      ######
##    ######  ##  ##  ##      ##
##  ##        ##    ##    ##  ##
##    ##  ##    ##    ####    ##
####  ##  ####    ##      ##  ##
##  ####    ####    ####  ##  ##
##      ##    ####  ##    ##  ##
####  ##  ##    ##    ##      ##
##        ##  ##  ##  ##  ##  ##
##  ######        ##        ####
##          ####    ##  ##      
################################
