################################
              ##            ####
####  ##  ####    ########    ##
##      ##      ##        ##  ##
##  ##  ##  ####    ##  ##    ##
##  ##  ##  ##  ##  ##    ##  ##
##  ##  ##        ######  ##  ##
##    ##  ##  ##  ####    ##  ##
####  ##    ##          ####  ##
##        ##    ##  ####      ##
##  ####      ##  ##      ##  ##
##    ########    ##  ##    ####
####            ####    ##    ##
##  ##########  ##  ##    ##  ##
##                  ##  ##      
################################
