################################
    ##      ##                ##
##      ##      ##  ########  ##
##  ##    ##  ##    ##        ##
##    ######    ##  ####  ##  ##
######      ##  ##      ##    ##
##      ##    ##    ##  ##  ####
##  ########    ####    ##    ##
##  ##  ######      ##    ##  ##
##  ##    ##  ####    ##  ##  ##
##    ##            ##    ##  ##
##  ####  ##  ##  ##    ##    ##
##      ##  ##        ##  ##  ##
##  ##        ########      ####
##    ##  ##            ##      
################################
