################################
                  ##  ##  ##  ##
##  ##  ########  ##          ##
##  ##  ##          ##  ########
####    ##  ######  ##        ##
####  ##    ##    ##    ####  ##
##    ##  ##  ##    ####      ##
##  ##          ##        ##  ##
##  ##  ######    ##  ####  ####
##    ##        ####          ##
####  ##  ##  ##      ##  ##  ##
####    ##    ##  ####  ####  ##
##  ##  ####  ##  ##          ##
##    ##        ####  ####  ####
####      ####        ##        
################################
