################################
                          ##  ##
########  ##  ######  ##      ##
##      ####  ##      ######  ##
##  ##      ##    ####        ##
##  ######      ##  ####  ##  ##
##        ##  ##        ##    ##
##  ####    ##    ####    ######
##  ##  ##    ##      ##      ##
####      ##    ##  ########  ##
##    ##      ####    ##  ##  ##
##  ##  ####      ##      ##  ##
##          ##########  ########
##  ####  ##      ##      ##  ##
##    ##      ##      ##        
################################
