################################
              ##        ##    ##
##  ##  ##  ##    ####      ####
##    ########  ##    ####    ##
####  ####      ####  ##    ####
##          ####      ##  ##  ##
##  ##  ##  ##    ##  ##      ##
##    ##        ##      ####  ##
##  ##    ##  ##    ##  ##    ##
####    ##  ##  ####  ##    ####
##    ##              ##  ######
####  ##  ##  ##  ##      ######
##    ##  ######  ##  ##    ####
##  ####        ##      ##    ##
##      ##  ####    ##    ##    
################################
