################################
                  ##    ####  ##
##  ##  ########    ##        ##
##    ##      ##  ####  ##  ####
####      ##    ##      ##    ##
##    ####    ####  ####  ##  ##
##  ##    ##          ##  ##  ##
##    ##    ##  ####      ##  ##
####    ##  ##      ##  ####  ##
##    ####    ####  ####      ##
####      ##    ####      ##  ##
##  ####    ##    ##  ##    ####
##        ##  ##  ##  ######  ##
####  ######  ##  ##      ##  ##
##                  ####        
################################
