################################
          ######  ##  ##      ##
##  ####    ##          ##  ####
##########      ######        ##
##  ####  ##  ##    ####  ##  ##
##          ##  ##      ####  ##
##  ##  ##  ##  ##  ##        ##
##  ##  ##  ##  ##    ##  ######
##  ##  ##  ##    ##    ##    ##
####    ##    ##    ##  ##  ####
##    ####  ##    ####  ##    ##
##  ##          ##      ####  ##
##  ##  ##  ##  ####  ##      ##
##    ##  ##  ##      ######  ##
####              ##            
################################
