################################
    ##          ##            ##
##      ########    ####  ##  ##
####  ##          ####    ##  ##
##    ####  ##  ####    ####  ##
##  ##        ##      ####    ##
##      ##  ##    ####      ####
##  ##    ####  ##    ##  ##  ##
##  ##  ##      ##  ##        ##
##    ##    ####      ######  ##
####  ##  ##      ##      ##  ##
####  ##      ######  ##  ##  ##
##      ######      ##    ##  ##
##  ##  ##      ##    ##  ##  ##
##    ##    ##    ##      ##    
################################
