################################
          ####      ##        ##
##  ######      ##      ####  ##
##  ##      ####  ######      ##
##  ##  ####      ##      ##  ##
##  ##    ##  ##    ##  ##    ##
##    ##      ####    ##  ##  ##
##  ######  ##    ##  ##    ####
##    ##  ##  ##  ##    ##    ##
####              ##  ######  ##
##    ######  ##  ##    ##    ##
####      ##  ##    ##  ##  ####
##  ####  ##    ####    ##    ##
##          ##        ##  ##  ##
##  ##  ##    ##  ##            
################################
