################################
      ##    ####  ##        ####
##  ##    ##        ##  ##    ##
##  ##  ##    ####      ####  ##
##  ##  ####      ######  ##  ##
##  ##      ####  ##          ##
##  ######  ##      ##  ####  ##
##      ##      ####    ##  ####
####  ##    ####      ##      ##
##      ####      ####    ##  ##
##  ##        ####  ##  ##    ##
##    ##########        ####  ##
##  ##            ######      ##
##  ################      ##  ##
##                    ####      
################################
