################################
        ##  ##    ##  ##  ##  ##
##  ##          ##            ##
##    ##  ####  ##  ##  ##  ####
####  ##    ######    ##      ##
##  ####  ##        ##    ######
##        ##  ##  ##  ##      ##
####  ##  ##    ##      ####  ##
##      ##  ##  ##  ####  ##  ##
##  ####            ##        ##
##    ##  ######  ##    ####  ##
####      ##    ####  ##      ##
##    ##      ##      ##  ##  ##
##  ##  ######    ####      ####
##  ##          ##      ##      
################################
