################################
      ##  ##        ##        ##
####      ##  ####      ####  ##
####  ##  ##  ##  ##  ######  ##
##    ##          ##    ##    ##
####    ######  ##    ##    ####
##  ##        ##    ####  ##  ##
##    ##  ####    ##      ##  ##
##  ##      ##  ##    ####    ##
##  ##  ##  ##    ##        ####
##      ####  ##  ##########  ##
####  ##      ##              ##
##    ####  ##  ##  ##  ##  ####
##  ##      ##    ##  ##      ##
##      ##    ##          ##    
################################
