################################
    ##          ##  ##        ##
##      ######          ####  ##
####  ####    ####  ####      ##
##        ##  ######      ######
##  ####  ##    ##    ####    ##
####  ##  ####      ##      ####
##    ##    ##  ####  ##  ##  ##
##  ##  ##  ##    ##          ##
##  ##        ##  ######  ##  ##
##  ########  ##        ##    ##
##        ##    ##  ##  ##  ####
####  ##    ##    ####        ##
##      ##    ##  ##  ####  ####
##  ##    ##      ##            
################################
