################################
        ##  ##      ##        ##
##  ##      ##  ##      ####  ##
##    ##  ####    ##  ##  ##  ##
######    ##    ##  ##    ##  ##
##      ##    ##      ##    ####
##  ####    ##    ##  ####    ##
##        ##  ##  ##      ##  ##
##  ######        ##  ##  ##  ##
##        ######    ##    ##  ##
########      ####    ##  ##  ##
##      ####      ##  ##  ##  ##
##  ##      ####  ##  ##  ##  ##
##  ##  ####  ##  ##  ##  ##  ##
##  ##                ##        
################################
