################################
    ##        ##      ####    ##
##    ##  ##      ##        ####
####    ##    ##    ########  ##
##  ##      ##  ##            ##
##    ####        ##  ##  ##  ##
####      ##  ##  ####  ####  ##
##    ##    ##  ##            ##
##  ##  ##      ##  ########  ##
##  ##    ######          ##  ##
##  ####      ####  ####    ####
##    ##  ##            ##    ##
####  ######  ##########    ####
##          ####      ##  ##  ##
##  ##  ##        ##            
################################
