################################
    ####    ##  ##            ##
##        ##      ####  ####  ##
##  ##  ##    ##    ##    ##  ##
####    ##  ##  ##      ##    ##
##    ####        ##  ##    ####
##  ##    ########    ##  ##  ##
##  ####          ####    ##  ##
##    ##  ##  ####      ####  ##
####      ##  ##    ####      ##
##    ####        ##    ##  ####
####  ##  ############        ##
##    ##          ##  ##  ##  ##
####  ########  ##      ####  ##
##                  ##          
################################
