################################
          ##      ####        ##
##  ####  ##  ##        ####  ##
##      ##    ##  ##  ##      ##
######  ##  ##  ##  ##    ##  ##
##      ##  ##      ##  ##  ####
##  ####      ##  ####        ##
##      ####  ##      ######  ##
##  ##        ##  ##  ##      ##
##  ####  ####  ##    ##  ##  ##
##      ##          ####    ####
####  ##    ######      ##    ##
##      ##      ######  ##  ####
##  ##    ######        ##  ####
##    ##          ####  ##      
################################
