################################
            ##      ####      ##
##  ######  ##  ##        ##  ##
##        ####    ####  ##    ##
##  ####      ##  ##  ####  ####
##      ##  ##    ##        ####
####  ##    ##  ##    ######  ##
##      ##  ####  ##  ##      ##
##  ##  ##        ##      ##  ##
##    ##    ##  ##    ####    ##
####    ####      ####  ##  ####
##    ##      ##        ##  ####
##  ##    ####  ######  ##    ##
##  ##  ##            ####  ####
##  ##      ##  ####            
################################
