################################
    ##                  ##    ##
##      ##########  ##      ####
##  ####        ##    ####    ##
##    ##  ####    ##  ##  ##  ##
##  ##    ######      ##      ##
##  ##  ##  ##    ####    ##  ##
######  ##  ##  ##      ##    ##
##      ##    ##    ####  ##  ##
##  ########    ######      ####
##      ##    ##        ##  ####
##  ##    ##      ########    ##
##    ##    ##  ##        ##  ##
##  ##  ##  ####    ##  ####  ##
##      ##        ##            
################################
