################################
    ##        ##  ##      ######
##  ##  ####        ####    ####
##      ##  ##  ##    ####    ##
##  ####    ####  ##    ####  ##
##    ####          ####      ##
####    ##  ##  ####      ##  ##
######  ##  ##        ######  ##
####    ##  ######  ####      ##
##    ######        ##    ##  ##
####    ##    ##  ##  ####    ##
##  ##  ####    ##          ####
##  ##      ##    ##  ##  ######
##    ##  ##  ##    ##      ####
####              ##    ##      
################################
