################################
            ##      ####      ##
##  ##  ##      ##        ##  ##
##  ##    ####    ########    ##
##  ##  ##      ##      ####  ##
##  ##    ##  ####  ##      ####
##    ##    ##        ####    ##
##  ##    ##    ####  ##  ##  ##
##    ##      ####  ##    ##  ##
##  ##  ######          ##    ##
##          ##  ####  ##    ####
######  ##  ##  ##  ####  ##  ##
##    ####  ##  ##  ##        ##
##  ##          ##  ##  ####  ##
##      ##  ##  ##      ##      
################################
