################################
          ##                ####
##  ####      ##  ####  ##    ##
##      ##  ####  ##      ##  ##
######    ##        ########  ##
##  ##  ##    ##  ##        ####
##  ##    ##    ####  ##########
##    ##    ##        ##    ####
####    ##    ##  ####  ##    ##
##    ######    ##      ####  ##
####  ####  ##    ####        ##
##            ##    ######  ####
##  ####  ##    ##      ##    ##
##    ##  ######    ##    ##  ##
####  ##          ######        
################################
