################################
    ##  ####        ####      ##
##            ####      ####  ##
########  ####      ##        ##
##          ######    ######  ##
##  ########      ####      ####
##        ##  ##    ##  ##    ##
##  ####  ##    ##      ####  ##
##    ##    ##    ######      ##
####  ##  ##    ##        ######
######    ##  ##  ##  ####    ##
####    ##    ##    ##      ####
##    ####  ##    ####  ##  ####
##  ##      ##  ##      ##    ##
##      ##          ##    ##    
################################
