################################
              ##  ##          ##
####  ####  ##    ##  ####  ####
##    ##        ####    ##    ##
##  ##  ##  ##  ##  ##    ##  ##
##  ##    ##        ##  ##    ##
##    ##      ##  ##      ##  ##
##  ##  ####    ##    ##  ##  ##
##          ####    ##    ##  ##
##  ######    ##  ##    ##    ##
####      ##        ####  ##  ##
##    ####  ##  ####          ##
##  ##        ##      ######  ##
##      ####  ####  ####      ##
####  ##            ##    ##    
################################
