################################
                  ##      ##  ##
##  ########  ##      ##  ##  ##
##  ##    ##    ######        ##
##  ####  ####      ########  ##
##    ##      ####          ####
####  ##  ##    ##  ######    ##
##      ##    ##        ####  ##
##  ##      ##    ####    ##  ##
##  ########    ########  ##  ##
####        ##    ##########  ##
##  ######    ##    ####      ##
##  ##    ##  ##  ##      ##  ##
##      ####  ####    ##    ####
##  ##              ######      
################################
