################################
      ##      ####        ##  ##
##  ##    ##      ##  ##  ##  ##
##    ##  ######      ##      ##
####  ####      ##  ##  ####  ##
####        ##    ##      ##  ##
##    ######  ##    ##  ##    ##
##  ##    ##  ####          ####
##    ##        ######  ####  ##
####    ##  ##        ##      ##
##    ##      ##  ##      ##  ##
####  ##  ##    ##    ######  ##
##    ########  ##  ##        ##
####      ##  ####  ##  ########
##    ##            ##          
################################
