################################
      ##                ##    ##
##  ##    ##  ########      ####
##      ####          ####    ##
##  ######    ######  ##  ##  ##
####      ##  ##      ##  ##  ##
##    ##  ##  ##  ####        ##
##  ##      ####      ######  ##
##    ####  ##    ####      ####
####  ##    ##  ##  ##  ##    ##
##    ##  ####      ##    ##  ##
##  ####      ####      ####  ##
##      ####    ##  ####      ##
##  ##      ##  ####      ##  ##
##    ##  ##          ####      
################################
