################################
      ##                  ##  ##
##  ####  ##  ####  ##  ##    ##
##        ##  ######  ##    ####
##  ########    ##      ##    ##
##  ##      ##      ##    ##  ##
##  ####  ##  ######  ##      ##
##    ##      ##  ##    ########
####      ####        ##      ##
##  ####        ####  ##  ##  ##
##      ##  ####  ##  ##  ##  ##
##  ##  ####      ##      ##  ##
##  ####      ##    ######    ##
##    ##  ####  ##      ####  ##
####              ####          
################################
