################################
      ##          ##      ##  ##
####  ##  ##  ##      ##      ##
##        ##    ######  ####  ##
####  ########  ##  ##        ##
##        ##    ##  ##  ########
##  ####  ##  ##    ##  ##    ##
####  ##  ##  ####          ####
##    ##  ##    ##  ##  ##    ##
##  ####    ##    ##      ##  ##
##      ##    ##  ##  ##    ####
##  ##    ##  ##    ##  ##    ##
##    ##  ##    ##  ##    ##  ##
##  ####    ##  ##    ##  ##  ##
##      ##        ##      ##    
################################
