################################
      ##          ##        ####
##  ####  ####  ##    ####    ##
##        ##    ##  ##    ##  ##
##  ##  ##  ##  ####    ####  ##
##  ####    ##        ##      ##
##        ##  ##  ##  ####  ####
######  ##    ##  ####      ####
##  ##      ####        ####  ##
##  ##  ##  ##  ##  ####      ##
##  ##    ##      ##      ######
##    ##      ##  ######      ##
####    ########      ##  ##  ##
##  ##  ##      ####  ######  ##
##          ##                  
################################
