################################
                  ##  ##      ##
##  ######  ####      ##  ##  ##
##  ##        ##  ####    ##  ##
##  ##  ##  ##      ##  ##    ##
######    ##    ####    ##  ####
##    ##    ####      ##      ##
####    ##    ##  ##  ####  ####
##    ##  ##        ##      ####
##  ##    ##  ##  ##    ##    ##
##    ##        ##    ######  ##
##  ##    ##  ##    ##  ##    ##
##    ######  ##  ##    ##  ####
##  ##      ##    ####  ##  ####
##      ##      ##              
################################
