################################
          ##  ##          ##  ##
####  ##        ##  ####      ##
##    ########    ##########  ##
####          ##    ####      ##
##    ########  ##        ##  ##
##  ##            ##  ####    ##
####    ##########      ##  ####
##    ##        ##  ##    ##  ##
##  ##  ##  ##  ##    ##      ##
##      ##  ##  ####    ####  ##
##  ####    ##      ##    ##  ##
##        ######  ##  ####    ##
##########  ##              ####
##              ##  ##  ##      
################################
