################################
    ####    ##        ####    ##
##      ##      ####        ####
##  ##  ####  ##    ######    ##
##  ##    ##  ##  ##      ##  ##
##    ##  ##          ##  ##  ##
##  ##      ####  ##  ##    ####
##    ##  ##    ##    ####    ##
##  ####      ######    ####  ##
##      ######  ##  ##    ##  ##
######  ##              ##    ##
##  ##  ##  ####  ##  ##    ####
##  ##  ##      ##  ##    ##  ##
##  ##  ########      ##      ##
##                ##      ##    
################################
