################################
    ##      ##  ####          ##
##    ##  ##        ##  ####  ##
####          ####    ####    ##
##    ########    ##      ##  ##
####        ####    ####  ##  ##
##  ######    ####      ####  ##
##  ##  ####    ####  ##      ##
##          ##    ##      ##  ##
##  ##  ##    ##      ####    ##
##    ##  ##    ######    ##  ##
####        ##  ##      ##    ##
##########  ##    ##  ##    ####
####          ##      ####  ####
##    ##  ##    ####            
################################
