################################
        ######        ##  ##  ##
##  ##    ##    ##  ##        ##
##    ##  ##  ##    ##  ##  ####
####  ##  ##  ####      ##    ##
##      ####      ##  ##    ####
####  ##      ##    ######    ##
##        ####  ##    ######  ##
####  ####        ##    ####  ##
##      ##  ####  ##  ##      ##
####  ##  ##  ##  ##  ##  ##  ##
##    ##      ##  ##  ##    ####
####    ##  ##    ####  ##    ##
##  ##      ##  ##        ##  ##
##      ##  ##      ####        
################################
