################################
            ##    ##      ##  ##
##  ######      ##    ##      ##
####        ####    ##  ##  ####
##    ####      ####        ####
####      ####  ##    ####    ##
##  ##  ##      ##  ##    ##  ##
##  ##    ##  ##        ##    ##
##    ######    ####  ##    ####
####        ##  ##    ######  ##
####  ##  ##    ####          ##
##    ##  ##  ##      ##  ##  ##
##  ##    ##  ######    ####  ##
##  ##  ##          ####      ##
##  ##      ##  ##        ##    
################################
