################################
              ######  ##      ##
##  ##  ####    ##    ##  ##  ##
##  ##  ####  ##    ####  ##  ##
##  ##      ##    ##      ##  ##
##  ######      ####  ####    ##
####        ####      ##    ####
##    ####  ##    ####    ##  ##
####      ##    ##  ##  ##    ##
##    ##  ##  ##    ##  ##  ####
##  ##    ##    ##  ##  ##    ##
##  ##  ##  ######  ##  ####  ##
##    ##            ##        ##
####  ##  ####  ####  ######  ##
##          ##                  
################################
