################################
    ##      ##        ##  ##  ##
##    ##  ##    ####          ##
##  ##    ##  ##      ##########
##  ##  ##      ####  ##      ##
##  ##      ##    ##  ##  ##  ##
##    ##  ##  ##  ##      ##  ##
####    ##      ##    ######  ##
##    ####  ##    ####        ##
##  ##        ##    ##  ####  ##
##    ##  ####    ##    ##    ##
####      ##    ####  ##    ####
##  ######    ##      ####    ##
##  ##      ##    ####    ##  ##
##      ##      ########        
################################
