################################
          ##        ##        ##
##  ####    ##  ####    ####  ##
##      ##      ##    ####    ##
##  ##    ####  ##  ##    ##  ##
##    ##    ######    ##      ##
####  ####        ##    ####  ##
####      ####  ####  ##  ##  ##
##    ####  ##        ##    ####
####          ####  ######    ##
##  ####  ##      ##  ##  ##  ##
##  ##  ##  ####  ##          ##
##          ##      ##  ####  ##
##  ######    ####  ##    ##  ##
##        ##            ##      
################################
