################################
      ##      ####      ##    ##
##  ##    ####      ##      ####
##      ##      ####    ##    ##
####  ##    ##      ##  ##  ####
##    ####    ####    ##      ##
####      ##    ##  ##    ##  ##
##    ##    ##    ##    ##    ##
##  ##    ##    ##    ##    ####
##  ##  ##    ####  ##  ##  ####
####    ##  ##      ##  ##    ##
##    ####  ##  ####    ####  ##
##  ##      ##  ##    ##      ##
##  ####  ####  ##  ####  ######
##            ##                
################################
