################################
          ####            ##  ##
####  ##        ########      ##
##    ####  ##  ##      ####  ##
##  ##  ##    ####  ##  ##    ##
##  ##    ##      ##      ##  ##
##  ##  ##  ####    ####    ####
##  ##  ##      ##    ####    ##
##  ##      ##    ##    ####  ##
##    ######  ##      ##      ##
##  ##          ##  ##    ##  ##
##  ##  ######  ####    ##  ####
##      ##  ##    ##  ####    ##
##  ######    ##  ##      ##  ##
##          ##        ##        
################################
