################################
        ####                ####
##  ##      ####  ##  ####    ##
##    ####  ##    ##      ##  ##
####    ##  ##  ##    ##    ####
##    ##  ##      ####  ##    ##
####      ##  ##          ##  ##
##    ####    ########  ##    ##
####      ####      ##  ##  ####
##  ####        ##    ####    ##
##      ####  ######      ##  ##
##  ##      ##  ##  ####      ##
##    ######          ####  ####
####          ##  ####        ##
##    ##  ##  ##        ####    
################################
