################################
                ##        ##  ##
####  ####  ##    ##  ##      ##
##      ##    ##  ##    ##  ####
########    ##    ########    ##
##        ##  ##            ####
##  ##  ##      ##########    ##
##    ##  ##  ##        ##  ####
####  ##        ##  ##        ##
##      ##  ####      ##########
####  ##          ####        ##
####  ##  ######    ##  ####  ##
##    ####      ####    ##    ##
##  ##      ##        ##    ####
##      ##    ##  ##    ##      
################################
