################################
        ##        ##      ##  ##
##  ##    ##  ##    ####      ##
##    ##      ####      ##  ####
##  ##    ####  ######      ####
##  ##  ##            ####    ##
##    ##    ######  ########  ##
####  ##  ##        ######    ##
##    ##    ##  ##    ##    ####
####    ##  ##    ##    ##  ####
##  ##  ##    ##  ####  ##    ##
##        ##  ##    ####  ##  ##
##  ####    ##  ##        ##  ##
##  ##  ##  ##  ##  ####  ##  ##
##      ##        ##            
################################
