################################
            ##        ##    ####
####  ####      ####    ##    ##
##  ####  ##  ##  ##  ##  ##  ##
##  ##      ##    ##  ##      ##
##      ##  ##  ##    ##  ##  ##
####  ####  ##  ##  ##    ##  ##
##    ##        ##    ##    ####
##  ##    ####    ##    ##  ####
##    ####    ##  ####  ##    ##
####  ##    ##      ##    ##  ##
##    ##  ####  ####  ##      ##
####  ##                ##  ####
##    ##################      ##
####                      ##    
################################
