################################
          ##      ##          ##
####  ##  ##  ##  ##  ##  ##  ##
##    ##      ##  ##  ##    ####
##  ##  ##  ##    ##    ##    ##
##  ##        ##    ##    ##  ##
##  ##  ######  ##    ##  ##  ##
##    ##        ####    ##    ##
####      ######    ##      ####
##  ######      ##    ####    ##
##          ##  ##  ##    ##  ##
####  ######            ####  ##
##        ######  ######      ##
##  ####        ##      ##  ####
##      ##  ##      ##          
################################
