################################
          ##  ##            ####
##  ####        ##########    ##
##  ##  ######  ##        ##  ##
##  ##      ##  ##  ####      ##
##  ##  ##      ##  ######  ####
##    ######  ##      ##      ##
####    ##      ####  ##  ##  ##
##  ##    ####  ####    ####  ##
##    ##    ##      ##      ####
##  ##  ##    ####  ######    ##
##        ##    ##        ##  ##
####  ##    ##    ######      ##
##  ####  ##    ##      ####  ##
##            ##    ##          
################################
