################################
          ##        ##        ##
####  ##    ##  ##      ####  ##
##      ##  ##  ####  ##      ##
##  ####    ##      ##    ##  ##
##  ##    ##  ##  ##    ####  ##
##    ##          ##  ##      ##
####    ##  ##  ##    ######  ##
####  ##  ##  ##    ##      ####
##    ##      ##  ####  ##    ##
##  ##  ##  ####      ##  ##  ##
##              ####      ##  ##
##  ######  ##    ##  ####    ##
####      ##  ##  ##      ##  ##
##    ##            ####        
################################
