################################
        ##    ##  ##  ##      ##
##  ##    ##            ##  ####
##    ##    ##  ######        ##
##  ##  ##    ##      ##  ##  ##
##  ##    ##  ##  ##  ##  ##  ##
##      ##    ######    ##    ##
##  ####    ##      ##      ####
####      ##    ##  ##  ##    ##
##    ####    ####    ##    ####
##  ##      ##    ##  ##  ##  ##
##      ####    ##    ##  ##  ##
##  ####      ##    ####      ##
##    ##  ##    ##      ####  ##
####        ##    ####          
################################
