################################
        ##  ##  ##            ##
##  ##  ##      ##  ####  ######
##  ##  ####  ##      ##      ##
##  ##    ##      ##    ####  ##
##  ####  ##  ##    ##    ##  ##
####  ##    ######    ##  ##  ##
####    ##    ##  ####  ##    ##
##    ##    ##            ##  ##
##  ##    ##    ########      ##
##      ##    ##      ##  ##  ##
##  ######  ##  ##  ####    ####
##  ##      ##          ##    ##
##  ##  ######  ######    ##  ##
##      ##            ##        
################################
