################################
      ##          ##      ##  ##
####      ##  ##      ##      ##
##    ####    ####  ##  ####  ##
####      ##      ##    ##    ##
##    ##    ####    ##  ##  ####
########  ##      ####      ####
##      ##    ######    ####  ##
##  ##    ##        ##        ##
##    ##    ######    ##  ##  ##
##  ##    ##      ##  ##    ####
####    ##    ##      ####    ##
##    ##    ##  ######    ##  ##
##  ##    ##        ##  ####  ##
##      ##    ####              
################################
