################################
    ##      ####    ####  ##  ##
##      ##        ##          ##
##  ####    ##  ##  ##  ##  ####
##      ##    ##      ##      ##
##  ##  ####      ##    ####  ##
##  ##      ######    ##      ##
##    ####  ##      ####  ######
####    ##    ######      ##  ##
######    ##      ##  ####    ##
####  ##    ####      ##  ##  ##
##      ##      ######        ##
##  ####  ####      ########  ##
##        ####  ##        ##  ##
##  ####          ##  ##        
################################
