################################
          ##  ##          ##  ##
##  ####  ##      ######      ##
####  ##  ##  ####        ##  ##
##    ##    ##      ######    ##
##  ##  ##    ####  ##      ####
##      ####  ##    ##  ##    ##
##  ##    ##  ##  ##  ##  ##  ##
##    ######  ##  ##      ##  ##
##  ##        ##      ##    ####
##  ##  ######    ##    ##    ##
##      ##      ##  ####  ##  ##
####  ############        ##  ##
##      ##        ##  ##  ##  ##
##  ##      ####      ##        
################################
