################################
            ##        ##      ##
##  ##  ##  ##  ####    ##  ####
##    ####      ##  ##        ##
####  ##  ######      ####  ####
##    ##  ##      ####  ##    ##
##  ##    ##  ##        ####  ##
##    ##  ##    ##  ##    ##  ##
##  ##    ##  ##    ##  ##    ##
##  ####        ##  ######  ####
##    ##  ########            ##
####    ##        ##  ##  ##  ##
##    ####  ####    ##      ####
##  ##        ##  ##    ##    ##
##      ####  ##    ##    ##    
################################
