################################
          ##      ##          ##
####  ####    ##      ##  ######
##      ##  ##  ####  ##      ##
##  ##  ##          ##  ####  ##
##    ##  ####  ####          ##
####      ####    ##  ##  ######
##    ####      ##      ##    ##
##  ##      ####  ##  ##    ####
##      ####      ##    ##    ##
##  ####      ##  ##  ##    ####
##      ####  ######    ##    ##
######    ##        ##    ##  ##
##    ##  ######  ##  ##  ##  ##
####                  ##        
################################
