################################
    ##          ##            ##
##      ######    ##  ######  ##
##  ####      ##  ##      ##  ##
##  ####  ##  ####    ##  ##  ##
##        ##      ##    ##    ##
##  ############    ##  ##  ####
##  ##    ##    ##      ##    ##
##    ##      ##  ######  ##  ##
####    ##  ##            ##  ##
##    ####      ##  ##  ##    ##
####      ##  ##      ##    ####
##  ####      ##  ####    ######
##    ##########  ##  ##    ####
####                    ##      
################################
