################################
    ########        ##        ##
##    ####    ####      ####  ##
####        ####  ####    ##  ##
####  ##  ####    ##  ##    ####
##    ####      ##      ##    ##
##  ##      ##  ##  ####  ##  ##
##  ##  ####        ##        ##
##  ##    ##  ##  ##    ##  ####
##      ##      ##    ####    ##
########    ##  ##  ##    ##  ##
##      ##    ##    ##  ##    ##
##  ##    ##  ##  ####  ##  ####
##    ######  ##  ##    ##    ##
####          ##      ######    
################################
