################################
      ##            ######    ##
##  ####  ##  ####    ##    ####
##  ##    ##      ##      ##  ##
##      ##  ####    ####      ##
##  ####        ##      ########
##  ##    ######    ##        ##
##  ##  ##      ####  ##########
##  ##      ##                ##
##  ######    ##  ##  ##  ##  ##
##        ##  ##  ##    ##    ##
########  ##  ##    ####    ####
##    ##    ##  ##  ##    ##  ##
####  ####      ##  ##  ####  ##
##          ##      ##          
################################
