################################
            ##    ##          ##
####  ####    ##  ##  ######  ##
##      ##  ##            ##  ##
##  ##  ##  ##  ##########    ##
##  ##  ##    ##            ####
##  ##  ####      ########  ####
##  ##    ##  ####      ##    ##
##    ##    ##  ##  ##      ####
##  ##  ##  ##    ##    ####  ##
##      ##  ####      ##      ##
######  ##    ##  ##      ######
##        ##    ##  ####  ##  ##
##  ####    ##  ##      ####  ##
##      ##  ##      ##          
################################
