################################
      ####  ##  ##  ##        ##
##  ##      ##          ########
##  ##  ####  ########        ##
##      ##          ########  ##
####  ##    ##  ##        ##  ##
##      ##  ##    ##  ##      ##
##  ##  ##    ##    ####  ##  ##
##  ##    ####  ##      ##    ##
####  ##        ##  ##  ##  ####
##      ####  ##    ##    ##  ##
##  ####  ##    ##    ##  ##  ##
##        ####    ####        ##
##  ####      ##      ####  ####
##      ####      ##            
################################
