################################
    ##  ##      ####        ####
##      ##  ##      ######    ##
##  ##  ##    ####        ##  ##
##  ##    ##  ##  ##  ##  ##  ##
####    ####        ##    ##  ##
####  ####  ######  ##  ##    ##
##          ##  ##    ##    ####
##  ######      ##  ##    ##  ##
##        ######    ##  ##    ##
####  ##      ##  ##      ##  ##
##      ####  ##  ######      ##
##  ####  ##  ##      ######  ##
##  ##    ##    ####          ##
##      ######        ##  ##    
################################
