################################
        ##      ####          ##
##  ##  ##  ####    ##  ####  ##
##  ##      ##    ##    ##    ##
##  ########    ####  ##    ####
##            ##      ####    ##
##  ######  ####  ####    ##  ##
##  ##    ##      ##  ##      ##
##  ####    ##  ##      ####  ##
##      ##          ##      ####
##  ####  ####  ####  ####    ##
##            ##        ####  ##
########  ##  ####  ##    ##  ##
##      ##      ##    ##  ##  ##
##  ##      ##      ##          
################################
