################################
                        ##    ##
##  ####  ########  ##      ####
##      ##            ####    ##
##  ####    ##########    ##  ##
####      ##            ##    ##
##    ####  ####  ##  ####  ####
####    ##        ##  ##    ####
##  ##  ##  ##  ##    ##  ##  ##
##    ##      ##    ####  ##  ##
####      ####    ##      ##  ##
##    ####      ######  ####  ##
####  ##    ##    ##          ##
##    ##  ##  ####    ######  ##
##  ##              ##          
################################
