################################
              ##      ######  ##
##  ##  ##  ##    ##    ##    ##
##  ##  ##      ##  ##      ####
##    ##  ######    ####  ##  ##
##  ##          ##            ##
####    ######  ##  ##  ####  ##
####  ####      ####      ##  ##
##    ##    ####      ####    ##
##  ##    ##      ####      ####
##  ##  ########      ##  ##  ##
##  ##    ##  ##  ##  ##  ##  ##
##  ####      ######  ##      ##
##    ########        ######  ##
####            ##  ##          
################################
