################################
                          ##  ##
####################  ##      ##
##                  ##    ##  ##
##  ####  ########    ##  ##  ##
##    ####        ##    ##    ##
####        ##  ##    ####  ####
##    ##  ####    ##        ####
######  ##      ##  ######    ##
##          ######        ##  ##
##  ##  ####        ##  ##    ##
##    ##    ##  ####    ##  ####
######    ##      ########    ##
##    ##  ##  ##          ##  ##
####            ##  ####        
################################
