################################
          ##  ##              ##
####  ##  ##    ####  ##  ##  ##
##      ##  ##  ##    ##    ####
####  ##    ##    ##    ##    ##
####      ######  ####  ##  ####
##    ####  ####    ####      ##
##  ##          ##      ##  ####
##      ####  ##  ####  ##    ##
##  ####                ####  ##
##  ##  ##  ######  ####  ##  ##
##  ##    ##      ##          ##
##  ####      ##    ##  ####  ##
##      ####    ##  ####  ##  ##
##  ##        ##                
################################
