################################
          ####  ##            ##
####  ##          ####  ####  ##
##    ##  ######  ##    ####  ##
####    ##    ##      ##      ##
##  ##  ####    ######    ##  ##
##  ##      ##  ##  ##  ####  ##
##  ######  ##      ##  ##    ##
##      ##  ##  ##  ##    ##  ##
####  ##  ##    ##    ##    ####
##          ######  ##  ##    ##
##  ######              ####  ##
##        ##  ##  ######      ##
########  ##  ####        ##  ##
##        ##        ##  ##      
################################
