################################
      ##      ##  ##          ##
####      ##  ##      ######  ##
##  ##  ##    ##  ##      ##  ##
##  ####  ##  ####    ##  ##  ##
##        ##      ##  ##  ##  ##
####  ##    ####    ##    ##  ##
####    ##      ##      ##    ##
##    ##    ####  ########  ####
##  ####  ##                ####
##      ##    ##  ##########  ##
##  ##    ##    ##            ##
##    ##    ##  ##  ##  ####  ##
##  ##  ##  ##  ######    ##  ##
##      ##              ##      
################################
