################################
      ##      ##        ##    ##
##  ##    ##    ##  ##    ##  ##
##  ##  ##  ##  ##    ##      ##
##  ##      ##    ##  ##  ##  ##
##    ####  ####  ##    ##    ##
##  ##  ##    ##    ####    ####
##        ##  ##  ##      ##  ##
##  ####  ##    ##    ##      ##
##      ##    ##  ##    ####  ##
##  ##    ##  ##    ##  ##    ##
##  ####  ##  ####      ##  ####
##    ##          ##  ####  ####
####  ##########      ##      ##
##              ##  ##    ##    
################################
