################################
      ##  ##              ######
####          ##########    ####
##  ##  ##  ##          ##    ##
##        ####  ####  ##    ####
##  ####      ##      ##  ##  ##
##      ####  ##  ####    ##  ##
##  ####  ##  ##      ##      ##
##    ##  ##  ######  ##  ##  ##
######    ##      ##    ##    ##
##      ##    ##    ##      ####
##  ####    ######    ##  ##  ##
##  ##    ##  ##  ##    ####  ##
##  ########        ##        ##
##            ####      ####    
################################
