################################
    ##          ##            ##
##      ######      ##  ####  ##
####  ##      ##  ####    ##  ##
##    ##  ####    ##  ##    ####
##  ####      ##  ##    ##    ##
##      ####  ##    ##  ####  ##
######  ##      ##  ##        ##
##  ##      ##  ##  ######  ####
##  ####  ##    ##        ##  ##
##      ##    ##  ######      ##
##  ##      ##    ##  ##  ##  ##
##    ######    ##    ##  ##  ##
####  ##      ##    ##    ##  ##
##        ##    ##      ##      
################################
