################################
            ##  ####          ##
##  ####  ##          ####  ####
##      ##    ##  ####        ##
##  ##      ####      ##  ##  ##
##  ##  ####    ####    ##  ####
##    ##      ####  ##        ##
####  ####  ##        ######  ##
####          ##  ##  ##      ##
##  ########  ##    ##    ######
##        ##    ##  ##  ##    ##
##  ####    ##  ##    ##  ##  ##
##  ##    ##    ####          ##
##  ##  ####  ##  ##  ######  ##
##  ##                ##        
################################
