################################
          ####  ##        ##  ##
##  ####            ##  ##    ##
##    ##  ##########        ####
####    ##          ##  ####  ##
##  ##  ##  ##  ##    ##      ##
##      ##    ##  ##      ######
##  ##    ##        ######    ##
##  ####    ####  ##        ####
##      ####  ##    ##  ####  ##
##  ##          ##  ##        ##
##  ##  ##  ##  ##  ##  ##  ####
##    ##  ##    ##    ####    ##
##  ##    ##  ####  ##      ####
##      ##              ##      
################################
