################################
    ##            ##          ##
##      ##  ####  ##  ######  ##
##  ####    ##    ##  ##  ##  ##
##  ####  ####  ##    ##  ##  ##
####      ##    ##  ##    ##  ##
##    ##  ##  ##    ####  ##  ##
##  ##  ##    ##  ##      ##  ##
##  ##      ##        ####    ##
####    ####  ####  ##      ####
##    ##        ##  ##  ##  ####
##  ######  ##    ####  ##    ##
##    ##    ##  ##      ####  ##
##  ##    ##        ####  ##  ##
##      ##    ##  ##            
################################
