################################
    ####      ##              ##
##        ####    ######  ##  ##
##  ##  ####    ##    ##    ####
####    ##    ##  ##    ##    ##
##    ##    ####      ##    ####
##  ##  ##      ##  ##  ##    ##
##      ######  ##        ##  ##
##  ##        ##    ##  ##    ##
####    ####    ##  ##  ####  ##
##    ##    ##      ##        ##
##  ######    ######  ####  ####
##  ####  ##              ##  ##
##        ##############      ##
####  ##                  ##    
################################
