################################
              ##  ##          ##
##  ##  ####        ##  ####  ##
####        ######    ######  ##
##    ##  ##      ##    ##    ##
##  ##    ##  ##    ##      ####
####  ####    ####    ####    ##
##          ##  ##  ##      ####
##  ####  ##      ####  ##  ####
##  ##  ##  ####        ##    ##
##            ##  ##  ######  ##
######  ####  ##    ##  ##    ##
##    ##      ##  ##      ##  ##
##  ##    ##    ##    ##  ##  ##
##      ######      ##          
################################
