################################
      ######        ##        ##
####    ##    ####    ##  ##  ##
##  ##      ##    ##      ##  ##
##    ##########      ##    ####
##  ##      ####  ##    ##    ##
##      ##      ##    ##    ####
####  ##    ##    ##    ##  ####
####    ########    ##  ##    ##
##  ##      ##  ##  ##    ##  ##
##    ####      ##  ####  ##  ##
####      ##  ##        ##    ##
####  ##    ##  ##  ##      ####
##      ##        ####  ##    ##
##  ##    ##  ##          ##    
################################
