################################
            ##  ##      ##    ##
####  ######        ##      ####
####          ##########  ##  ##
##    ####  ##      ####      ##
##  ##    ##    ##      ##  ####
##    ##      ##  ######    ####
####  ####  ####        ##    ##
##      ##  ##    ####    ##  ##
####  ##    ##  ##    ##      ##
##        ##    ##  ##    ##  ##
########    ##  ##  ##  ##  ####
##      ##  ##  ##  ##  ##    ##
##  ####  ##    ##  ##  ####  ##
##            ##                
################################
