################################
      ##            ##      ####
####      ##  ####      ##    ##
##    ####    ##  ####    ##  ##
##  ####    ##    ##    ####  ##
######    ##  ##      ##    ####
##      ##        ####    ######
##  ####    ######  ##  ########
##    ##  ##        ##    ######
####    ##    ##  ##  ##    ####
####  ####  ##          ##    ##
##    ##    ####  ####    ##  ##
##  ##    ##  ##      ######  ##
##  ##  ####    ####          ##
##            ##      ##  ##    
################################
