################################
          ##      ##  ##      ##
##  ####  ##  ##        ##  ####
##    ##  ##    ####  ##      ##
##  ####      ##    ##    ##  ##
##      ##########      ##    ##
######  ##    ####  ####    ####
##  ##  ##  ##        ##  ##  ##
##  ##  ##      ########      ##
##  ##  ##  ####        ####  ##
##      ####      ####        ##
##  ####      ####  ##  ####  ##
##        ####        ##      ##
############    ####  ##  ######
##            ##                
################################
