################################
        ##########        ##  ##
##  ##    ######    ##  ##    ##
####  ##    ##    ####      ####
##      ##    ##      ##  ######
##  ##    ##    ####  ##  ######
##    ##  ##  ##      ##    ####
##  ####  ##  ##  ####  ##    ##
##      ##    ##  ##      ##  ##
##  ##  ##  ##        ####    ##
##  ##  ##  ########  ##    ####
##  ##  ##        ##  ##  ##  ##
##  ##    ##  ##    ####      ##
##  ####    ####  ##      ##  ##
##      ##            ####      
################################
