################################
    ##  ##            ##  ##  ##
##          ##  ##  ##        ##
##  ####  ##      ##    ##  ####
####      ##  ##  ##  ####    ##
####  ##  ####  ##    ##  ##  ##
##      ##      ##  ##    ##  ##
##  ####    ##          ####  ##
##        ##  ######  ##      ##
##  ##  ##          ##    ##  ##
##    ####  ##  ##    ##    ####
####      ##  ##  ##    ##  ####
##  ####              ##      ##
##        ##  ########  ####  ##
##  ##  ######                  
################################
