################################
            ####      ##      ##
##  ##  ##        ##      ##  ##
####      ##  ##    ######    ##
##    ##    ########      ######
##  ####  ##  ##      ##      ##
##      ####      ####  ####  ##
##  ##      ##  ##      ##    ##
##    ####    ##    ##      ####
####  ######      ##  ##  ##  ##
####    ##  ##  ##    ##  ##  ##
##  ##        ######    ##    ##
##  ####  ##    ##  ##      ####
##    ##  ####        ##  ##  ##
####          ##  ##            
################################
