################################
        ##  ##        ##      ##
##  ##      ##  ####      ##  ##
##    ####  ##  ##  ##  ##    ##
####  ##    ##      ##    ##  ##
##    ##  ##  ####    ##  ##  ##
##  ##            ##  ##    ####
##    ####  ##  ##    ####  ####
####    ##    ##    ##    ##  ##
##  ####    ##    ##    ##    ##
##        ##    ##  ##      ####
####  ##  ##  ##        ##    ##
##    ####      ####  ##  ##  ##
##  ##      ####      ##  ##  ##
##      ##        ####          
################################
