################################
        ##          ##      ####
##  ##    ##  ####  ##  ##    ##
##  ######    ##      ######  ##
##        ##  ######    ####  ##
########  ##        ##        ##
##        ##  ##  ##  ##  ##  ##
##  ##  ##    ##      ##  ##  ##
##    ######    ####    ##    ##
####    ##    ##    ##  ##  ####
##  ##    ##      ##      ##  ##
##  ####  ##  ##    ####      ##
##    ##  ##    ####      ##  ##
####        ####      ##    ####
##    ####        ##    ##      
################################
