################################
      ##  ##          ##  ######
####          ########      ####
##    ####  ####        ##    ##
##  ##      ##    ####  ####  ##
######  ####    ####  ##      ##
##        ##  ##      ##  ######
##  ########    ##  ####      ##
##            ##        ####  ##
##  ##########  ######    ##  ##
##  ##      ##        ##  ##  ##
##  ####  ##    ##  ##    ##  ##
##          ####    ##  ##    ##
######  ##        ##    ####  ##
##        ##  ##    ##          
################################
