################################
        ##        ##        ####
##  ####    ####    ######    ##
##    ##  ####    ##      ##  ##
##  ##    ##    ##    ##      ##
##  ##  ##  ####  ##    ####  ##
##      ##          ##      ####
##  ####  ########    ####    ##
##    ##        ####        ####
##  ##    ####        ####    ##
##      ####  ########    ##  ##
##  ######    ##      ##  ##  ##
####        ##    ##      ##  ##
##    ##  ##    ##    ##  ##  ##
##  ##        ##    ##          
################################
