################################
        ##      ##  ##    ##  ##
##  ##  ##  ##        ##      ##
##  ####      ########    ######
##      ##  ##        ##      ##
##  ##  ##      ##  ##    ##  ##
##  ##    ######    ####  ##  ##
####    ##      ##      ##    ##
##    ##    ##    ####  ##  ####
##  ##    ##    ##      ##    ##
##      ##    ##  ##  ######  ##
##  ####    ##    ##    ##    ##
##      ##      ##  ##      ####
##  ####  ####          ##    ##
##            ##  ##  ######    
################################
