################################
        ##  ##          ##    ##
##  ##  ##      ##  ##    ##  ##
##  ##      ######    ####    ##
##  ##  ####      ##    ##  ####
##    ##      ########  ##    ##
##  ##    ##      ####    ##  ##
##  ##  ##    ##      ##  ##  ##
##    ##  ####    ##      ##  ##
####          ####    ##  ##  ##
####  ##  ##      ####    ##  ##
##    ####  ####  ##    ####  ##
##  ##        ##  ######      ##
##    ##  ##  ##      ##  ######
####      ##    ####            
################################
