################################
      ##  ##  ##              ##
####          ##  ##  ##  ##  ##
##    ####  ####    ##    ##  ##
##  ##  ##  ##    ##    ####  ##
##  ##  ##      ##    ##      ##
##  ##    ##  ####  ##    ######
##      ######      ##  ####  ##
############    ####    ##    ##
##      ##    ##  ##  ##    ####
######  ##  ##    ##    ##    ##
##  ##      ##  ####  ##  ##  ##
##    ######    ##            ##
##  ####      ##    ########  ##
##        ##      ##            
################################
