################################
            ##                ##
##  ####  ##    ##  ########  ##
##  ##        ##    ##        ##
##    ##  ####  ##  ##  ####  ##
####    ##      ##  ##      ####
##  ##    ####  ##  ##  ##    ##
##    ##  ##    ##    ######  ##
##  ####  ##  ##  ##    ##    ##
##        ##      ####    ######
##  ##  ####  ##      ##      ##
####    ##      ####    ####  ##
##    ##    ####  ####  ####  ##
##  ####  ##  ##      ##      ##
##              ####      ##    
################################
