################################
                ##    ##      ##
##  ##########    ##      ##  ##
##  ##        ##  ##  ######  ##
####    ####  ##      ##      ##
##    ##      ##  ####    ##  ##
####  ##  ##  ##    ##  ##    ##
####  ##    ##    ##    ##  ####
##      ##    ####    ##    ####
##  ####  ##    ##  ##  ##    ##
##        ####  ##        ##  ##
##  ######  ##  ####  ##    ####
####        ##      ##  ##    ##
##    ##  ##  ####  ##      ####
##  ##                  ##      
################################
