################################
      ##          ##    ##    ##
####      ########    ##    ####
##    ##  ##      ##    ##    ##
##  ##  ##    ##    ##    ##  ##
##      ##  ##    ##    ####  ##
##  ##  ##    ##    ##        ##
##  ##    ##  ##  ##  ######  ##
##  ##  ##    ##      ##  ##  ##
##    ##    ##    ##      ##  ##
####  ##  ##  ##    ##  ##    ##
##    ##      ##  ####  ##  ####
##  ##    ##  ##  ##    ##    ##
##    ####    ##    ######  ####
####        ######              
################################
