################################
      ####  ##        ##      ##
####            ####  ##  ##  ##
##  ##  ####  ##  ##    ##    ##
##  ##    ####      ##  ##  ####
##  ####      ####      ##  ####
##      ####    ##  ####      ##
####  ##  ####  ##  ####  ##  ##
####          ####      ##    ##
##    ##  ##      ####    ##  ##
##  ######  ####      ##  ##  ##
##    ##      ##  ####    ##  ##
####      ##  ##      ##      ##
####  ##    ##  ####  ######  ##
##      ##        ##            
################################
