################################
    ##        ##      ##      ##
##  ##  ####      ##  ##  ##  ##
##      ##  ####  ##    ##    ##
####  ##      ##    ##  ##  ####
##    ####  ##    ##          ##
##  ##  ##  ##  ####  ######  ##
##          ##  ##  ##        ##
########  ##    ##  ####  ##  ##
##          ##  ##      ##    ##
####  ####  ##    ####  ##  ####
##    ##  ##    ##  ##    ##  ##
##  ####  ##  ##      ##  ##  ##
##        ##      ####        ##
####  ##    ####        ####    
################################
