################################
                    ##        ##
##  ##  ####  ####    ##  ##  ##
##    ##  ##      ##  ####    ##
##  ##    ######  ##        ####
##      ##        ##  ####    ##
##  ######  ##  ##  ##    ##  ##
####        ####      ##      ##
##    ######      ##  ##  ######
##  ##      ##  ####  ##      ##
##    ####    ##        ####  ##
####  ##  ##    ##  ####      ##
####      ####        ##  ######
##  ######  ##  ####  ##  ##  ##
##                ##            
################################
