################################
        ##      ##      ##    ##
##  ##      ##      ####    ####
##    ######  ##  ####    ######
##  ##        ##        ##  ####
####    ####    ####  ##      ##
##    ##    ##  ##    ##  ##  ##
####      ##    ####    ####  ##
##  ######    ##  ####        ##
##          ##        ##  ##  ##
##  ##########  ####      ##  ##
##  ##              ####  ######
##  ##  ########  ##  ##      ##
##  ######      ##      ####  ##
##          ##      ##          
################################
