################################
            ##        ##    ####
##  ##  ##      ####    ##    ##
##  ####    ####  ##  ##  ##  ##
####      ##      ##      ##  ##
##    ####    ##########      ##
##  ##    ##      ##    ####  ##
##  ##  ####  ##    ##        ##
##  ##        ####      ########
##  ########      ##  ##      ##
##          ##  ##      ####  ##
##  ##  ##    ##    ##    ##  ##
##    ##  ##  ##  ##    ##    ##
####      ##  ####  ######  ####
##    ##  ##                    
################################
