################################
    ##        ##        ##    ##
##      ####    ##  ####    ####
##  ##    ######          ##  ##
##  ##  ##        ##  ##      ##
##  ####    ########    ####  ##
##      ##  ##      ##    ######
##  ##  ##    ####    ##      ##
####      ##  ##  ##    ####  ##
##    ####    ##    ##    ##  ##
##  ####    ##  ##      ####  ##
##  ##    ##        ####      ##
##    ##    ##  ##  ##    ##  ##
####    ##  ####    ##  ####  ##
######            ######        
################################
