################################
      ####                ##  ##
##  ##      ##  ######  ##    ##
##      ####    ##  ##      ####
##  ####      ##    ######  ####
##    ##  ##    ##            ##
####  ##    ####    ########  ##
##      ##      ####        ####
##  ####  ####  ##    ####    ##
##  ##    ##    ##  ####  ##  ##
##  ##  ##    ##    ##      ####
##  ##  ##  ##    ##    ##    ##
##  ##  ##    ##  ####    ##  ##
##  ##    ##          ##  ##  ##
##      ##    ##  ##      ##    
################################
