################################
      ##  ##    ##      ####  ##
##  ##      ##      ##        ##
##      ##  ##  ####  ######  ##
##  ####    ######        ##  ##
##    ##  ##        ####      ##
####  ##      ########  ##  ####
##    ##########          ##  ##
####              ######      ##
##  ######  ##  ##      ####  ##
##        ##  ####  ######    ##
##  ######          ##      ####
##          ####  ##    ####  ##
##  ########  ##  ##  ##      ##
##            ##          ##    
################################
