################################
        ####  ##        ##    ##
##  ##            ####    ##  ##
##    ############    ##      ##
####  ##            ######  ####
##    ##  ######  ##  ####    ##
##  ####      ##          ##  ##
##      ####    ########  ##  ##
######      ##  ##        ##  ##
##    ####    ##    ##  ####  ##
##  ##    ##    ##    ##      ##
##    ##      ######      ######
##  ####  ####  ##    ####    ##
##      ##  ##      ##      ####
##  ##          ##      ##      
################################
