################################
        ##    ##              ##
####  ##    ##  ########  ##  ##
####      ##            ####  ##
##    ####    ####  ##        ##
####      ####  ##    ##  ##  ##
##  ####          ##  ####  ####
##  ##  ########  ##          ##
##            ##  ##  ##  ##  ##
####  ######  ##  ####    ##  ##
##          ####      ##  ##  ##
##  ######      ####  ##  ##  ##
##  ##    ####    ##    ##    ##
##    ##      ##    ##  ####  ##
####      ##    ##              
################################
