################################
          ##  ##      ####    ##
##  ########      ##      ##  ##
##  ##      ##  ##  ####  ##  ##
##  ##  ##    ##    ##    ##  ##
##        ##      ##    ##    ##
##  ######  ####    ##      ####
##  ##        ##  ##  ####  ####
##  ##  ##  ##          ##    ##
##  ##  ##  ##  ##  ##  ##  ####
##  ##    ####    ##    ##    ##
##    ##      ##  ####  ####  ##
####  ##  ##  ##      ##      ##
##      ##      ####      ##  ##
##  ##      ##      ##  ##      
################################
