################################
        ##      ##  ##        ##
##  ##      ####        ####  ##
##    ####        ##  ##    ####
##  ##    ##  ######      ##  ##
##  ##  ##  ####    ######    ##
##      ##        ####      ####
##  ##    ####  ##      ##    ##
##  ##  ##          ########  ##
####    ##  ####  ####  ##    ##
##    ##    ##  ##      ##  ####
##  ######  ##      ##  ##  ####
##    ##    ####  ##  ####    ##
##  ##    ##  ##  ##      ##  ##
##      ##            ##        
################################
