################################
    ##            ##      ##  ##
##      ########      ##  ##  ##
####  ####      ######    ##  ##
##    ##    ##        ##  ##  ##
##  ##  ######  ####      ##  ##
##  ##        ##    ####  ##  ##
##      ####    ##  ##        ##
####  ##      ####    ##  ##  ##
##    ##  ##      ##    ##  ####
##  ####    ####    ##        ##
##      ##    ####  ####  ##  ##
######  ####    ##      ##    ##
##          ##    ########  ####
##  ##  ##    ##                
################################
