################################
                ##  ##        ##
##  ####  ######        ##  ####
##  ####          ######      ##
##      ########      ##  ##  ##
##  ##  ##      ####  ##    ####
####    ##  ##  ####    ##    ##
##    ##    ##      ####  ##  ##
##  ##  ##    ####            ##
##  ##      ##      ##  ##  ####
##    ##  ##########  ####    ##
######      ##        ##    ####
##      ######  ######  ##    ##
##  ######      ##  ##  ##  ####
##          ####                
################################
