################################
          ##    ##  ##        ##
##  ##  ##    ##        ##  ####
####        ##    ######      ##
##    ####  ##  ##    ##  ##  ##
####    ##  ##      ####    ####
##  ##    ####  ##      ##    ##
##    ##          ##  ##    ####
####      ######    ##    ##  ##
####  ####      ####    ##    ##
##          ##    ##  ####  ####
##  ########    ##    ##    ####
####      ##  ##    ##    ##  ##
##    ##  ##  ##  ##  ##      ##
##  ##        ##          ##    
################################
