################################
    ####      ##              ##
##        ##    ####  ######  ##
##  ##########    ##      ##  ##
##        ######      ##  ##  ##
########    ##  ######    ##  ##
##        ##        ##  ##    ##
##  ##  ####  ########    ######
##    ##      ##      ##      ##
####      ######  ##  ######  ##
##    ####        ####        ##
####    ##  ######      ####  ##
##  ##  ##  ##      ####  ##  ##
##      ##  ##  ####  ##      ##
##  ##  ##      ##        ##    
################################
