################################
      ##        ##  ##        ##
##  ##    ##  ##        ####  ##
##    ##  ##      ####  ####  ##
####  ##    ##  ##    ##      ##
####      ##  ##  ##  ##  ##  ##
##    ####            ##    ####
##  ##  ##  ####  ##    ##    ##
##  ##      ##      ##  ####  ##
##  ##  ####    ####  ##      ##
##    ##      ######      ##  ##
####  ######    ##  ##  ##  ####
####          ##      ##      ##
##  ########  ##  ##    ####  ##
##                  ##          
################################
