################################
        ##            ##########
##  ##      ########    ########
##  ##  ####        ##    ######
##  ####    ##  ##    ##    ####
##      ##        ########    ##
##  ##  ##  ####      ##    ####
######  ##    ######  ##  ##  ##
##      ######        ##  ##  ##
##  ####        ####  ##  ##  ##
##  ##    ######  ######      ##
##    ##                ####  ##
####    ##  ######  ##  ##    ##
##  ##  ####      ####    ##  ##
##            ##      ##        
################################
