################################
    ##  ##        ##    ##    ##
##          ####  ####    ##  ##
####  ##  ##          ##      ##
##    ##    ########    ####  ##
####  ##  ##        ##        ##
##      ##    ##  ##  ######  ##
##  ##  ##  ##    ##        ####
##  ##  ##  ##  ####  ####  ####
##    ##  ##          ##      ##
####        ####  ####    ##  ##
##    ####      ##  ##  ##  ####
####      ####      ##  ##    ##
##  ##  ####  ##  ##      ##  ##
##            ##      ##        
################################
