################################
                    ##  ##    ##
####  ##  ##  ####  ##      ####
##    ##    ##      ##  ##    ##
####  ####    ##  ##    ####  ##
##        ##  ##      ##      ##
##  ######    ####  ##  ##  ####
##  ##      ##  ####          ##
##  ##  ####          ######  ##
######  ##    ##  ####    ##  ##
##      ##  ##    ##    ##  ####
##  ##    ##  ##      ####    ##
##    ####      ####      ##  ##
####  ####  ##    ##########  ##
##            ##                
################################
