################################
                  ##        ####
##  ####  ######    ##  ##    ##
##    ##  ##    ##      ####  ##
##  ##    ####  ##  ####  ##  ##
##    ##    ##    ##      ##  ##
######  ##    ##      ####    ##
##      ##  ##    ##  ##    ####
##  ##      ##  ####      ######
##    ##  ##  ####    ####  ####
##  ##  ##        ####  ##    ##
##      ##  ####          ##  ##
##  ##  ##  ##    ####  ##    ##
##  ####      ####  ##    ##  ##
##        ##          ##        
################################
