################################
        ##    ##      ##      ##
##  ##      ##    ##  ##  ##  ##
##  ##  ##      ####  ##  ##  ##
####      ##  ##          ##  ##
##    ####  ##  ##  ####    ####
####              ##  ####    ##
##  ############  ##    ##  ####
##                  ##        ##
##  ####  ##  ##  ##    ####  ##
##  ##  ##  ##  ##    ##  ##  ##
##  ##              ####    ####
##  ####  ####  ##      ##    ##
##      ##    ##    ##    ##  ##
##  ##      ##    ######        
################################
