################################
                  ##          ##
##  ##########  ##    ######  ##
##  ##      ##  ####  ##      ##
##  ##  ##  ##      ##    ##  ##
##  ##  ####  ####  ##  ##    ##
##  ##          ##      ##  ####
##    ##  ##  ##  ####  ##    ##
####  ##    ##        ##  ##  ##
##      ##      ##  ##        ##
##  ##  ########    ##  ########
##  ##          ##      ##    ##
##    ##  ####  ##  ####    ####
##  ##  ##  ##  ##        ##  ##
##      ##        ##  ##        
################################
