################################
        ##          ##        ##
####  ##    ##  ##    ######  ##
##      ####  ##  ##          ##
##  ##    ##      ####  ####  ##
##    ##  ##  ##      ##      ##
####  ##  ##    ##  ##    ######
##    ##    ##  ##      ##    ##
####  ##  ####    ######    ####
##    ##      ##  ##      ######
######  ####  ##  ##  ##  ######
##            ##      ##    ####
##  ######  ##  ##  ##  ##    ##
##      ####      ##      ##  ##
##  ##        ##      ##        
################################
