################################
      ##  ##      ##      ##  ##
####        ####      ##  ##  ##
##    ####      ##  ##    ##  ##
##  ######  ####    ####      ##
##    ##          ##    ####  ##
##  ##    ########    ##      ##
##  ##  ##          ##  ##  ####
##  ####    ####  ##        ####
##      ##  ####      ######  ##
######  ##      ######    ##  ##
##  ####  ####  ##    ##      ##
##        ##        ##  ##  ####
##  ##  ##    ####  ##      ####
##  ##      ##          ##      
################################
