################################
    ####                ##    ##
##        ####  ######    ##  ##
##  ##########  ##      ##    ##
##        ##    ##  ####  ##  ##
##  ##  ##    ##    ####      ##
##    ##    ##    ##      ##  ##
##  ##    ##    ##    ####    ##
##  ##  ##  ##  ##  ####    ####
##  ##  ##  ##    ####    ##  ##
##  ##  ##    ##        ####  ##
##  ##  ##  ##  ######        ##
####    ##            ##  ##  ##
##    ##  ##  ########      ####
##  ##                  ##      
################################
