################################
    ##              ##        ##
##  ##  ####  ####    ####  ####
##      ##    ######  ##      ##
##  ######  ##  ##    ##  ##  ##
####        ##    ##    ##    ##
####  ######  ##    ##      ####
##    ##          ##  ####  ####
##  ##    ######        ##    ##
##    ##        ####  ######  ##
####    ##  ####  ##    ##    ##
##  ##  ##        ####      ####
##        ##  ##    ##  ####  ##
##  ####  ##  ####    ##  ##  ##
##      ##        ##            
################################
