################################
        ##    ##              ##
####  ##  ##      ##########  ##
##          ##  ####      ##  ##
##  ##  ##    ##      ##      ##
##  ##  ##  ##    ####  ##  ####
####    ####    ##  ##  ####  ##
##    ##      ##              ##
##  ##    ####    ########  ####
##  ####  ##    ##      ##    ##
##        ##  ##    ##      ####
##  ##  ##      ##    ####    ##
####      ####  ##  ##    ##  ##
##    ##      ####    ##      ##
##  ##    ##        ##    ##    
################################
