################################
            ##        ##      ##
##  ######      ####      ##  ##
##        ##  ####  ##  ##    ##
########  ####        ####  ####
##    ##      ##  ####      ####
##  ##  ####  ##        ####  ##
##          ##    ########    ##
##  ####  ##    ##        ##  ##
##      ####  ##    ####  ##  ##
##  ##  ##    ####    ##      ##
####    ##  ##      ##  ####  ##
##    ##      ##  ####        ##
##  ##  ####  ##  ##    ##  ####
##                ##  ##        
################################
