################################
    ####          ##          ##
##        ##  ##  ##  ######  ##
######  ##  ####  ##  ##      ##
##      ##        ##    ########
##  ##    ##  ##      ##      ##
##    ##    ##########    ##  ##
####    ##    ##      ##  ##  ##
##  ##    ######  ##      ##  ##
##      ##          ######    ##
##  ##      ##  ##  ##      ####
##    ##  ####    ##    ##    ##
##  ##  ##      ##    ####  ####
##  ##  ########    ####      ##
##  ##            ##      ##    
################################
