################################
          ######      ####    ##
####  ##    ##    ##        ####
####  ##  ##    ##  ##  ##    ##
##    ##  ##  ##      ##    ####
##  ##    ##  ##  ####    ##  ##
##    ##    ##      ##  ##    ##
####    ##    ####        ##  ##
##    ##  ##    ##  ####  ##  ##
##  ##    ####    ######      ##
##    ##      ##    ##  ####  ##
####      ##    ##        ##  ##
######  ##  ##  ##  ########  ##
####        ##  ####          ##
##    ####  ##        ##  ##    
################################
