################################
    ##      ##              ####
##      ##  ##  ##########    ##
##  ####  ##    ##        ##  ##
##    ##    ##      ##  ####  ##
####    ##  ##########  ##    ##
##  ##  ##              ##  ####
##  ##    ####  ########      ##
##    ##  ##            ##  ####
##  ####  ##  ##  ##  ##      ##
##  ##    ####  ##    ##  ##  ##
##  ##  ##        ##  ##    ####
##  ##      ####  ##    ##    ##
##    ######  ##  ##  ##  ##  ##
####                  ##        
################################
