################################
        ##    ##        ##    ##
##  ##      ##    ##  ##  ##  ##
##  ##  ##  ##  ####      ##  ##
##  ####  ##    ##  ######    ##
##        ##  ##        ####  ##
##  ##  ####    ##  ##    ##  ##
##  ##      ##      ####  ##  ##
##    ####    ##  ##  ##  ##  ##
##  ##    ##    ##        ##  ##
##      ##    ####  ######    ##
######    ##        ##      ####
##    ##  ##  ######    ##    ##
####        ##        ##  ##  ##
##    ####      ##  ##          
################################
