################################
    ####            ####      ##
##        ########        ##  ##
##  ######        ######  ##  ##
##  ##      ####        ####  ##
##  ##  ####    ######        ##
##  ##  ##    ##      ##########
##  ##    ##      ####        ##
##    ##  ##  ##        ####  ##
##  ##  ##      ##  ########  ##
##        ####  ##      ##    ##
####  ##      ##    ##    ######
##  ##  ####  ##  ##  ##      ##
##      ####  ####      ####  ##
##  ##              ##          
################################
