################################
              ##          ##  ##
##  ##  ####    ##  ####      ##
##  ##  ######      ##  ####  ##
##  ##    ##    ######        ##
##    ##  ##  ##      ##  ######
####  ##    ##    ##  ##      ##
##  ##    ##    ####  ##  ##  ##
##      ##    ##        ##    ##
####  ##  ##  ##  ####    ######
##        ##    ##    ##      ##
##  ##  ##  ##      ##  ####  ##
##    ##      ######      ##  ##
####      ##      ##  ##  ##  ##
##    ##    ####      ##        
################################
