################################
                ##  ##        ##
##  ##  ######  ##      ##  ####
##  ##  ##  ##  ##  ##  ##    ##
######  ##  ##    ##    ####  ##
##      ##    ##  ##  ##      ##
##  ##    ##      ####    ##  ##
##    ######  ##        ##    ##
####        ##  ########    ####
####  ####  ##        ##  ##  ##
##    ##    ##  ####  ##  ##  ##
######    ##  ##          ##  ##
##      ##      ##  ##  ####  ##
##  ######  ##    ##          ##
##            ####    ##  ##    
################################
