################################
    ##      ##  ##  ##    ##  ##
##  ##  ##            ##  ##  ##
##  ##    ####  ####  ##  ##  ##
##  ##  ##  ##    ##  ##  ##  ##
##  ##  ##    ##  ##  ##      ##
##  ##    ##  ##  ####  ##  ####
##    ##  ##  ##        ##    ##
####  ##  ##    ####  ##  ##  ##
##    ##  ##  ##  ##  ##      ##
####  ##  ##      ##    ##  ####
####  ##  ##  ####  ##  ##    ##
##    ##  ##        ##      ####
##  ##      ##  ##    ######  ##
##      ##        ##            
################################
