################################
    ######                ##  ##
##    ##    ##########  ##    ##
####      ##        ##      ####
##    ##    ##  ####  ####  ####
##  ##  ##  ##          ##    ##
##      ##  ##  ##  ##    ##  ##
##  ##  ##    ##      ##      ##
##    ##    ##    ##    ########
##  ##    ##    ######        ##
####    ##    ##  ##  ##  ##  ##
####  ##    ##    ##  ##    ####
##    ######    ##    ####    ##
##  ##      ##  ####    ##  ####
##      ##            ##        
################################
