################################
    ####      ##      ##  ##  ##
##      ####      ##          ##
##  ##    ######  ######  ##  ##
##    ##        ##      ##    ##
##  ##########  ##  ##      ####
##    ##      ##      ####    ##
####  ####  ##  ####    ####  ##
####    ##        ####      ####
##  ##  ##  ####    ##  ##    ##
##  ##  ##  ##  ##  ##  ####  ##
##  ##  ##      ##    ##      ##
##  ##    ####    ##  ##  ##  ##
##    ##      ##  ##  ##  ##  ##
####      ##      ##      ##    
################################
