################################
    ####    ##  ##  ##      ####
##        ##        ##  ##    ##
##  ##  ####  ####  ##    ##  ##
##  ##        ##    ######    ##
##    ########  ##        ##  ##
####  ##          ######      ##
####  ##  ######      ##  ######
##      ####      ##    ##    ##
##  ##        ####  ##  ##  ####
####  ########      ##      ####
##              ####  ####    ##
##  ########  ##        ##  ####
##  ##      ##    ####        ##
##      ##      ##      ####    
################################
