################################
      ##              ##  ##  ##
####      ########  ####  ##  ##
##    ####      ##  ##    ##  ##
##  ##      ##  ##  ##  ##    ##
##      ####    ##      ####  ##
####  ##  ####    ##  ##      ##
######        ##    ##  ##  ####
####    ####    ##  ##        ##
##    ##    ##      ##  ####  ##
####      ##  ##  ####  ##    ##
##    ####      ##      ##  ####
####        ##  ##  ##  ##    ##
##  ##########  ####  ##  ##  ##
##                              
################################
