################################
            ##            ##  ##
##  ##  ####    ########      ##
##  ##        ##        ##  ####
##    ##  ##  ##  ####  ##    ##
####    ##  ##    ##      ##  ##
######  ##      ##    ##  ##  ##
######    ######    ##    ##  ##
####  ##  ##      ##    ##    ##
##    ##  ##  ######  ##    ####
##  ##        ##      ####  ####
##  ##  ##  ##  ##  ##  ##    ##
##      ####    ##        ##  ##
##  ####  ##  ##  ##########  ##
##        ##                    
################################
