################################
            ####  ##          ##
##  ##  ##          ##  ####  ##
##  ##    ####  ##  ##  ##  ####
##    ##  ##  ##    ##  ##  ####
########  ##      ##    ##    ##
##        ##  ####    ##  ##  ##
##  ######      ####      ##  ##
##        ####        ######  ##
##  ####  ##    ##  ##        ##
##    ##    ##    ##    ##  ####
##  ##    ##    ##    ##    ####
####    ##    ##    ##    ##  ##
##    ##  ####    ##  ##      ##
####            ##        ##    
################################
