################################
    ##      ##      ##      ####
##      ##    ##  ##    ##    ##
##  ####  ##  ##      ##  ##  ##
########      ####  ####      ##
##  ##    ####      ##    ######
##  ##  ##    ##  ####  ##    ##
##      ##  ##    ##    ####  ##
####  ##        ####  ##      ##
##    ##  ##  ##      ##  ######
##  ##    ##    ##  ##        ##
##  ####    ####    ##  ####  ##
##      ##  ##    ##  ##      ##
##  ##      ##  ##        ##  ##
##    ##  ##        ##  ##      
################################
