################################
            ##              ####
####  ######    ##  ##  ##    ##
##    ##      ##    ##    ##  ##
##  ##    ####    ########  ####
##  ##  ##  ##  ######        ##
##  ##      ##    ##    ####  ##
##  ##  ##    ##  ##  ######  ##
##    ####  ##    ##    ##    ##
####        ##  ##  ####    ####
##############        ##  ##  ##
####            ##  ##    ##  ##
##    ##  ##########    ####  ##
##  ##  ##      ####  ##      ##
##          ##            ##    
################################
