################################
      ##          ##      ##  ##
##  ##    ##  ##    ####      ##
##      ##      ##        ##  ##
##  ####    ##  ############  ##
##      ##    ##            ####
####  ##    ##    ##  ####    ##
####  ##  ####  ##    ##    ####
##      ##      ##  ##    ##  ##
##  ##  ##  ####  ##    ####  ##
##  ####    ##    ##  ##      ##
##    ##  ##    ##        ##  ##
####        ##    ##  ######  ##
####  ######    ##    ##      ##
##            ##    ##    ##    
################################
