################################
      ##  ##      ##  ####    ##
####          ##  ##        ####
##  ####  ######    ##  ##    ##
##        ##    ##  ##    ##  ##
##  ######  ##  ##  ####    ####
##      ##      ##      ##    ##
##  ##  ######    ####    ##  ##
##  ##      ####      ##  ##  ##
##    ####    ##  ##      ##  ##
####      ##  ##    ######    ##
##  ######      ##  ##      ####
##        ##  ##    ##  ##  ####
##  ####      ####  ##  ##    ##
##      ##  ##            ##    
################################
