################################
        ##########            ##
##  ##    ######    ####  ##  ##
##    ##    ##    ##  ##  ##  ##
##  ##    ##    ##    ##  ##  ##
##    ####    ####  ##      ####
####  ##    ##      ##  ##    ##
####      ##    ##    ##    ####
##    ####    ########    ##  ##
##  ##      ##  ##      ##    ##
##  ####  ##        ##      ####
##    ##  ##  ##  ##  ####    ##
####  ##  ##  ####    ##  ##  ##
##        ##      ##      ##  ##
##  ####    ####  ##  ##        
################################
