################################
    ##  ##    ####            ##
##          ##      ####  ##  ##
##  ####  ##    ######    ######
##    ##      ##      ##      ##
####    ######    ####  ####  ##
####  ##    ##  ##  ##    ##  ##
##    ##  ##    ##    ##      ##
##  ##      ##    ##    ####  ##
##    ##  ##  ##    ##        ##
####  ##  ##    ##  ####  ######
##    ##      ####    ##      ##
##  ##  ##  ##    ##  ##  ##  ##
##  ##      ####  ##  ######  ##
##      ##        ##            
################################
