################################
      ##      ##  ##          ##
##  ##  ####          ##  ##  ##
##        ##  ########    ##  ##
##  ####  ##          ##    ####
####  ##  ####  ##  ##  ##    ##
##    ##      ##    ##    ##  ##
##  ########    ##      ##    ##
##    ##      ##    ##  ##  ####
####  ##  ####    ##  ##      ##
####      ##    ##        ##  ##
##    ####    ##    ##  ##    ##
####      ####    ##    ##  ####
##  ####      ####    ####  ####
##        ##        ##          
################################
