################################
              ##              ##
####  ##  ##      ####  ########
##    ####  ##  ##    ##      ##
##  ##      ##    ##      ##  ##
##      ####  ##  ##  ######  ##
######        ##  ##  ##      ##
##      ##  ##    ##  ##  ######
##  ####  ##  ##  ##  ##      ##
##    ##  ##  ##  ##  ##  ##  ##
####  ##  ##  ##        ##    ##
##    ##  ##    ##  ##    ##  ##
##  ##      ##  ####  ##  ##  ##
##    ####  ##        ######  ##
####          ##  ##            
################################
