################################
            ##      ##    ##  ##
##  ####  ##    ##    ##      ##
##  ####      ##    ##    ##  ##
##      ##  ##    ##  ##  ##  ##
##  ##    ##  ##      ##  ##  ##
##    ##  ##  ####  ##    ##  ##
####  ##  ##        ######    ##
##    ##    ########        ####
####    ##        ##  ######  ##
##  ##    ##  ##  ##  ##  ##  ##
##  ####  ####    ##  ##      ##
##    ##    ##  ##      ####  ##
####    ##  ##  ####  ##      ##
######      ##            ##    
################################
