################################
        ####      ####        ##
##  ##        ####      ####  ##
##    ##  ##  ##    ########  ##
##  ##  ####  ##  ####  ##    ##
##  ##        ##        ##  ####
##  ##  ##  ##  ####  ##    ####
##  ##    ##          ##  ##  ##
##    ####    ##  ####    ##  ##
####    ##  ##  ####    ##    ##
######      ##      ####    ####
####    ####  ####  ##  ##    ##
##    ##        ##        ##  ##
##  ##    ####  ##  ####      ##
##      ##          ##    ##    
################################
