################################
    ##  ##            ##      ##
##        ########  ##    ##  ##
##  ####            ##  ##    ##
##    ##  ####  ######    ##  ##
####  ##    ####        ##    ##
##      ####      ######    ####
##  ##  ##    ####        ##  ##
##  ##    ##  ##    ######    ##
##    ##  ##    ####        ####
##  ##      ##      ##  ##    ##
##  ##  ##  ####  ##    ####  ##
##  ##  ####      ##  ##      ##
##  ##    ##  ####    ##  ######
##    ##            ##          
################################
