################################
    ##      ##          ##    ##
##      ####    ######    ##  ##
####  ######  ##      ##      ##
##      ##    ##  ##    ##  ####
##  ##    ##      ##  ##  ##  ##
##    ##    ######    ##      ##
##  ##    ##      ##  ######  ##
##  ##  ######  ####          ##
##  ##  ####        ##  ####  ##
##  ##      ##  ##    ##      ##
##  ######      ##  ##    ######
##      ##  ####  ####  ##    ##
##  ##  ####              ##  ##
##  ##        ##  ##  ##        
################################
