################################
        ##      ##        ######
##  ##  ##  ##    ##  ##    ####
##    ####    ##  ##    ##    ##
####        ##    ####  ####  ##
##    ######    ##          ####
####      ##  ############    ##
##  ##  ####    ##      ##  ####
##  ##      ##  ######  ##    ##
##    ####  ##      ##    ##  ##
##  ##  ##  ######      ##    ##
##      ##      ########    ####
##  ##    ####        ##  ##  ##
##    ##    ######  ##        ##
####    ##              ####    
################################
