################################
          ##        ##      ####
##  ##  ##    ####  ##  ##    ##
####        ##  ##      ####  ##
##    ##  ##    ########  ##  ##
##  ##  ######        ##      ##
##  ##    ##    ##  ####  ######
##    ##  ##  ##    ##    ##  ##
####      ##    ##  ##  ##    ##
##  ##  ##    ####      ##  ####
##    ##    ##    ######      ##
####      ##  ##        ##  ####
##    ####      ##  ##        ##
####  ####  ##  ####  ##  ##  ##
##          ##            ##    
################################
