################################
      ##        ########  ##  ##
####      ##  ##  ####        ##
##    ##  ##  ##        ####  ##
##  ##      ##  ####  ##      ##
####  ####      ######    ##  ##
##      ##  ##    ##    ##  ####
##  ##      ##  ####  ##      ##
##    ####    ##      ##  ##  ##
####      ##  ##  ##########  ##
##    ##  ######  ##  ##      ##
##  ####          ##      ##  ##
##  ##  ##  ######    ####    ##
##        ##        ##  ##  ####
####  ##      ##  ##            
################################
