################################
        ####        ##  ##    ##
##  ##        ##  ##      ##  ##
##    ########        ##  ##  ##
####  ##        ####  ##      ##
####  ##  ######    ##  ####  ##
##    ##  ##    ##        ##  ##
####  ##    ##    ##  ####    ##
##    ##  ##  ##      ##    ####
##  ##    ##      ####    ##  ##
####    ##    ####      ##    ##
##    ##  ##    ##  ####    ####
####      ####          ##    ##
####  ##      ##  ####      ####
##      ####    ##      ##      
################################
