################################
    ######                ##  ##
##    ##    ########  ##      ##
####      ####      ##    ##  ##
##    ####      ##  ########  ##
##  ##      ####              ##
##  ##  ##  ##  ####  ######  ##
##  ##    ##        ##      ####
####    ####  ##  ##    ##    ##
##    ##      ##      ##    ####
####      ####  ######  ##    ##
##    ####      ##        ##  ##
##  ####    ##  ##  ####      ##
##      ####    ##  ##  ##  ####
##  ##        ######            
################################
