################################
      ##              ##  ##  ##
####  ##  ##  ######          ##
##        ##      ######  ##  ##
##  ####  ##  ##        ####  ##
##  ##      ##  ##  ##      ####
####    ##        ##  ####    ##
##    ##  ######      ##  ##  ##
##  ##            ##      ##  ##
####  ##  ##  ####  ####  ##  ##
##      ##    ##        ##    ##
##  ####    ##    ####  ##  ####
##      ##  ##  ##  ##  ##    ##
##  ##    ##    ##  ##  ####  ##
##    ##      ##                
################################
