################################
                  ##      ######
##  ####  ######  ##  ##    ####
##  ##  ##      ##      ##    ##
##          ##      ####  ######
##  ########  ######          ##
##  ##    ##          ######  ##
##  ####    ##  ####        ####
##      ##      ##########    ##
##  ##  ##  ####  ##    ##  ####
##    ##            ##  ##    ##
####  ##  ########        ##  ##
##    ####        ########    ##
##  ##      ####          ##  ##
##      ####      ##  ##        
################################
