################################
            ####        ##    ##
##  ##  ####      ####    ##  ##
##  ##    ##  ########  ##    ##
##    ##  ##  ##  ##    ####  ##
##  ####  ##  ##      ##      ##
##      ##    ##  ####    ##  ##
##  ##    ######    ##  ####  ##
##    ##        ##      ##    ##
##  ##########    ########  ####
##    ##      ##            ####
####  ##  ##    ######  ####  ##
####  ####    ##      ##      ##
##      ##  ####  ##    ##  ####
##  ##              ##          
################################
