################################
    ##          ##          ####
##      ##  ##  ##  ######    ##
##  ####    ####    ##    ##  ##
##  ##    ##      ##  ##    ####
####    ##    ####      ##    ##
##    ##    ##  ##  ##  ##  ####
##  ##    ##        ##  ##    ##
##  ####  ####  ######    ##  ##
##          ##  ##      ####  ##
##  ##  ####    ##  ####      ##
##  ####      ####  ######  ####
##      ##  ####      ####    ##
######  ##  ##    ##        ####
##          ##  ######  ##      
################################
