################################
      ##          ##        ####
##  ##    ######    ##  ##    ##
##  ##  ##      ##  ##  ####  ##
##    ##    ####    ##    ##  ##
##  ##    ##      ##  ##  ##  ##
##  ####  ##  ####        ##  ##
##        ##      ####  ##    ##
####  ##    ####        ##  ####
##      ##    ##########    ####
##  ##  ######          ##    ##
##  ##          ####  ######  ##
##    ##########  ##    ##    ##
####  ##          ####    ##  ##
##        ##  ##      ##        
################################
