################################
              ##  ##        ####
##  ##  ####      ##  ####    ##
####    ##    ######    ####  ##
##    ##    ##        ##      ##
######    ####  ##  ##    ######
##      ####    ##    ##  ##  ##
##  ##  ##    ##  ####    ##  ##
##  ######  ##      ##  ##    ##
##          ######    ##  ##  ##
####  ######      ##          ##
##    ##      ##    ########  ##
##  ##    ####  ##        ##  ##
##      ##      ########  ##  ##
####  ##    ##                  
################################
