################################
            ##    ##      ##  ##
##  ##  ##    ##  ##  ##      ##
##  ####  ##      ##    ####  ##
##          ####    ##    ##  ##
##  ######      ##  ####  ##  ##
##  ##    ####    ##      ######
##      ##    ##      ####    ##
######  ##  ##########      ####
##            ##      ####    ##
##  ####  ####    ##      ##  ##
##  ##        ####    ##  ##  ##
####    ####    ##  ####      ##
##    ########      ##  ####  ##
##  ############  ##            
################################
