################################
      ##  ##  ##              ##
####          ##  ####  ####  ##
##  ####  ######  ##    ##    ##
##    ##  ##      ##  ##    ####
##  ##        ####      ##    ##
##    ##########    ####    ####
##  ##          ##  ##    ##  ##
##      ######      ##  ##    ##
########    ##  ####      ##  ##
##      ##    ##    ####  ##  ##
##  ##  ####      ##      ##  ##
##  ####      ####    ####    ##
##    ##  ##    ##  ####  ##  ##
####        ##                  
################################
