################################
        ######            ##  ##
##  ##    ##    ##  ####      ##
##    ####    ##        ####  ##
####    ##  ##    ####  ##    ##
##  ##    ##    ##      ########
##    ##    ####  ##  ##      ##
####  ####        ##  ##  ##  ##
##      ########  ##      ##  ##
##  ##        ##    ##  ##    ##
##  ####  ##    ##  ##  ##  ####
####        ######  ##  ##  ####
##    ##  ##        ######    ##
####    ####  ######      ##  ##
######                ##        
################################
