################################
          ##                ####
##  ####      ####  ######    ##
##  ######  ##    ##    ####  ##
##    ##    ####      ##      ##
##  ##    ##      ##  ##  ##  ##
####    ##    ####    ##    ####
##    ##    ##  ##  ##  ##  ####
####  ##  ##            ##    ##
##    ##    ##  ##  ##    ##  ##
####      ##    ####  ##  ##  ##
##  ####  ##  ##      ####    ##
##    ##    ####  ##      ##  ##
####  ######      ######  ##  ##
##            ####              
################################
