################################
                ##      ##    ##
########  ##  ##    ##      ####
##        ##    ######  ##    ##
##  ######    ##      ##  ##  ##
##  ##      ####  ##      ##  ##
##  ######          ##  ##    ##
##        ##  ####  ##  ##  ####
##  ####    ##    ##    ##  ####
##  ######    ##      ##      ##
##    ######  ##  ##    ####  ##
####    ##    ##    ####      ##
##  ##    ##    ##        ##  ##
##  ##  ##  ##  ####  ##    ####
##            ##        ##      
################################
