################################
              ##              ##
##  ####  ##    ##  ####  ##  ##
##  ##    ####    ####      ####
####    ##      ##    ####    ##
##    ####  ####    ##      ####
##  ##      ##    ##  ##  ##  ##
##  ##  ######  ##            ##
##  ##  ##      ########  ##  ##
##  ##      ####      ##    ####
##    ########    ##  ####  ####
####  ##        ##      ##    ##
##      ##  ####  ####  ####  ##
##  ####    ####          ##  ##
##        ##      ##  ##        
################################
