################################
        ##          ##      ####
##  ##  ##  ##  ##  ##  ##    ##
##  ##  ##    ##  ##      ##  ##
##  ##    ##      ##  ####    ##
##  ##  ##  ####  ##    ##  ####
##  ##        ##    ##  ########
##  ##  ####      ####      ####
##  ##    ######      ####    ##
##    ####      ####      ##  ##
####        ##      ##  ##    ##
##    ############    ##    ####
####  ##    ##    ##      ##  ##
##      ##      ##  ########  ##
##  ##      ##                  
################################
