################################
          ##    ####      ##  ##
####  ##  ##  ##      ##      ##
##    ##      ########    ##  ##
####    ######        ####    ##
##  ##  ##      ####  ##    ####
##      ##  ####      ##  ######
##  ####    ##    ####      ####
##  ##  ##    ##    ######    ##
##  ##  ##  ##  ##        ##  ##
##          ##    ####  ##    ##
############  ##        ##  ####
##            ##  ######      ##
####  ####  ##        ######  ##
##      ##      ####            
################################
