################################
        ##      ####    ########
##  ##  ##  ##      ##    ######
##  ####      ####    ##    ####
##        ####  ##  ##  ##    ##
##  ######      ##  ##    ##  ##
##          ##  ##    ##  ##  ##
####  ##  ####    ####        ##
##  ##  ##    ##  ##    ##  ####
##        ##  ##  ##  ####    ##
##  ####  ##  ##  ####      ####
##  ##        ##    ##  ##    ##
##    ######  ####  ##    ##  ##
####        ##        ##  ##  ##
##    ####      ####      ##    
################################
