################################
          ##  ##    ##      ####
####  ####      ##      ##    ##
####        ##      ##  ####  ##
##    ######  ########      ####
####  ##      ##      ####    ##
##    ######    ##  ##  ##  ####
####        ##          ##  ####
##  ######  ##  ####  ####    ##
##      ##  ########      ##  ##
######          ##    ######  ##
##    ########      ##        ##
##  ##      ##  ######  ####  ##
##  ##  ##    ##        ####  ##
##        ##      ##  ##        
################################
