################################
                  ##      ##  ##
######  ##  ##  ##    ##      ##
##    ##    ##  ##########  ####
####  ##  ##          ##      ##
##    ##  ##  ######      ##  ##
##  ##      ##      ######    ##
##  ######    ##  ##    ##  ####
##      ####  ##      ##    ####
##  ##    ##  ##  ####    ##  ##
####    ##    ##        ####  ##
##    ##    ##  ##  ##        ##
####    ##        ##  ######  ##
##  ##  ########  ##  ##  ##  ##
##                ##            
################################
