################################
            ##  ##        ##  ##
##  ######        ##  ##      ##
##        ##  ##  ##  ######  ##
##########  ##    ##      ##  ##
##          ##  ##    ####    ##
####  ##  ##    ######      ####
##    ##  ##  ##        ##    ##
####  ##  ##    ##  ####  ##  ##
##    ##  ##  ##    ##    ##  ##
##  ##    ##  ##  ##    ####  ##
##  ##  ##    ##    ##        ##
##  ##    ##  ####  ##  ##  ####
##  ######      ##  ##    ##  ##
##          ##        ##        
################################
