################################
          ##            ##    ##
##  ##  ##    ########      ####
##    ##    ##        ####    ##
####      ##  ##  ##      ##  ##
####  ##  ##      ######    ####
##    ##  ##  ####      ##    ##
##  ########  ##    ####  ##  ##
##    ##      ####  ##    ##  ##
##  ####  ####          ##    ##
##      ##      ########    ####
##  ##      ######        ##  ##
##    ##  ##        ######    ##
####  ##  ##  ######      ##  ##
##    ##              ##        
################################
