################################
              ####            ##
##  ####  ##      ##  ##  ##  ##
##  ##    ######    ##    ##  ##
####    ##      ##  ##  ##    ##
##    ##    ####      ######  ##
##  ##  ##        ##    ####  ##
##  ##      ####    ##        ##
##    ##  ##    ####  ####  ####
####  ##  ##  ##          ##  ##
##    ##      ##  ######  ##  ##
####    ########  ##      ##  ##
##    ##          ##  ####    ##
##  ##    ##  ######      ##  ##
##      ##          ####        
################################
