################################
        ##                    ##
####  ##    ####  ######  ##  ##
##      ##      ##    ##  ##  ##
##  ##    ##  ##    ##    ##  ##
##    ##  ##  ##  ##    ##  ####
####  ##      ##    ##  ##    ##
##      ##  ##  ##  ##  ##  ####
##  ######          ##  ##    ##
####      ##  ########    ##  ##
####  ##    ##          ##    ##
##      ##      ####  ##    ####
##  ########  ##  ##  ##  ##  ##
##      ##  ##      ##        ##
##  ##          ##      ####    
################################
