################################
    ##              ##        ##
##      ####  ##  ##    ####  ##
####  ##  ##    ##    ####    ##
####  ##    ##    ##  ##    ####
##    ##  ####  ####    ##    ##
##  ####            ##    ##  ##
##      ##  ######    ####    ##
##  ##  ####      ######    ####
##  ##        ##          ##  ##
##    ##  ####  ##########    ##
####    ##                ##  ##
##  ##    ######  ##  ##  ##  ##
##  ##  ##      ####  ##  ##  ##
##          ##        ##        
################################
