################################
        ########            ####
##  ##    ####    ########    ##
##  ####        ####      ##  ##
##      ####  ##      ##  ##  ##
##########      ##  ##    ##  ##
##        ####  ##  ##  ##    ##
##  ####        ##  ####    ####
##  ##  ########          ##  ##
##  ##            ##  ##      ##
##    ##  ##  ####  ##  ####  ##
####    ####  ##    ##    ##  ##
##  ##      ####  ##  ##      ##
##  ##  ##  ##    ##  ##  ######
##      ##      ##              
################################
