################################
        ##  ##        ##      ##
##  ##        ####  ##    ##  ##
##    ##  ##    ##      ##    ##
##  ##    ####      ##    ##  ##
####    ##    ##########    ####
##    ##  ##        ##  ##    ##
##  ##      ##  ##      ##  ####
##      ##    ######  ####    ##
########  ##    ##        ##  ##
##        ######  ##  ##      ##
####  ##      ##  ##    ##  ####
##      ##  ##      ##    ##  ##
##  ##    ####  ##  ####  ##  ##
##    ##        ##              
################################
