################################
              ##              ##
##  ##  ####    ##  ######  ####
####    ##  ##          ##    ##
##    ##      ##  ####  ####  ##
####      ####  ########      ##
##  ####  ##      ####    ##  ##
##  ##    ##  ##        ##    ##
##      ##    ########    ##  ##
##  ######  ##        ##    ####
######      ##  ##  ##  ##    ##
##      ######  ##        ##  ##
##  ####          ##  ##      ##
##  ##  ####  ##    ##  ########
##          ######              
################################
