################################
            ##                ##
####  ####  ##  ########  ##  ##
##    ##    ##  ##      ##  ####
##  ####  ##    ##  ##        ##
##  ##    ####  ##  ##  ####  ##
##    ##        ####  ##      ##
####  ######  ##        ##  ####
##          ####  ####  ##    ##
##  ######        ##      ##  ##
##  ##  ##########  ##  ##    ##
##  ##          ##  ##    ##  ##
##    ####  ##        ##  ##  ##
####      ##  ##  ##  ##  ##  ##
##    ##          ##  ##        
################################
