################################
      ##                      ##
####      ##  ##########  ##  ##
####  ####  ##          ##    ##
##          ##  ######      ####
##  ##########  ##    ####    ##
####            ##  ##      ####
##    ##  ######      ####    ##
####    ##    ##  ##      ##  ##
##    ####  ##  ####  ##      ##
####        ##          ####  ##
##  ##  ####    ########    ####
##  ##    ##  ##        ##    ##
##    ####      ##  ##    ##  ##
####        ##        ##        
################################
