################################
                              ##
########  ####  ######  ####  ##
##      ####    ##  ##      ####
##  ##      ##        ####  ####
##    ####    ##  ##    ##    ##
####    ####    ##  ####  ##  ##
##  ##    ####  ##            ##
##      ##      ####  ######  ##
##  ####    ##    ##      ##  ##
##      ####    ##    ##  ##  ##
##  ####    ####    ##    ##  ##
##      ##        ##    ##    ##
##  ##    ##########  ####  ####
##    ##              ##        
################################
