################################
    ##          ##          ####
##      ##  ##  ##  ##  ##    ##
####  ##  ##  ##    ##  ##  ####
##                ##    ##    ##
####  ##  ########    ##  ##  ##
##    ####      ##  ####      ##
##  ##      ##  ##      ####  ##
##    ##  ##      ####  ##    ##
##  ##    ##  ####  ##    ##  ##
##  ##  ##    ##      ##    ####
##      ##  ##    ##  ####    ##
####  ####      ######      ####
##  ##      ##  ####    ##    ##
##      ##    ##      ######    
################################
