################################
      ####      ####    ####  ##
####        ##        ##      ##
##  ##  ##    ##  ####    ##  ##
##  ##    ######    ##  ####  ##
##      ##      ####    ##    ##
##  ####    ##        ######  ##
##  ##    ##  ############    ##
##    ##  ##          ##    ####
####    ####  ##  ##  ##  ##  ##
##  ##        ##  ##  ##      ##
##  ##  ########    ######  ####
##  ##          ##    ##      ##
##    ####  ####  ##    ####  ##
####                ##          
################################
