################################
          ##      ##  ##      ##
##  ####  ##  ##          ##  ##
##  ##    ##    ##  ##  ##  ####
##    ##    ##  ##  ##        ##
####    ######    ##  ##  ##  ##
##  ##        ##  ##    ##    ##
##      ####  ##  ####  ##  ####
####  ##  ##  ##    ##  ##    ##
##    ##      ####        ##  ##
##  ##    ####      ########  ##
##    ##  ##    ####          ##
####  ##    ##      ##  ########
##      ##    ##  ##  ##      ##
##  ##    ##              ##    
################################
