################################
        ######                ##
##  ##    ##    ##  ##  ####  ##
##    ##    ####    ##      ####
####    ##      ####  ####    ##
##  ##  ######            ##  ##
##    ##      ##  ######  ##  ##
####  ##  ##  ####    ##  ##  ##
##        ##        ##    ##  ##
######  ##    ######    ##    ##
##      ##  ##      ##  ##  ####
##  ####    ##  ##  ##  ##    ##
##    ######    ##  ##      ####
####        ##  ##    ####  ####
##    ####        ##            
################################
