################################
    ####  ##      ##          ##
##          ##  ##    ##  ##  ##
####  ####      ####    ##    ##
##    ##  ####    ##  ##    ####
####        ##########    ##  ##
##    ####        ##  ##  ##  ##
##  ####  ##  ##      ##  ##  ##
####        ##  ##  ##    ##  ##
####  ####  ##  ##  ##  ##    ##
##    ####  ##      ##      ####
##  ##          ##  ######    ##
##  ##  ##  ####  ##      ##  ##
##    ##  ##      ##  ##  ##  ##
####          ##      ##        
################################
