################################
          ####      ##        ##
####  ##      ####      ####  ##
##    ######      ##  ##  ##  ##
####      ####  ##        ##  ##
##    ##    ##    ##  ##  ##  ##
######  ##    ##  ##    ####  ##
##          ##    ##  ##      ##
##  ##  ####  ##  ##  ##  ##  ##
##    ##            ##    ##  ##
##  ##    ####  ##  ##  ##    ##
##  ##  ####  ##    ##    ##  ##
##    ##      ##  ##  ##  ##  ##
####  ##  ####        ##  ##  ##
##        ##    ####      ##    
################################
