################################
            ##          ####  ##
####  ####  ##  ######        ##
####      ##    ##    ##  ##  ##
##    ##    ##      ##    ##  ##
##  ##  ##    ##  ##    ####  ##
##        ##      ##  ##      ##
##  ######  ####  ##  ####  ####
####            ####      ##  ##
####  ####  ##      ####      ##
##    ##  ########      ##  ####
##  ##      ##    ####  ##    ##
##  ##  ####  ##        ####  ##
##  ##  ##      ####  ##  ##  ##
##      ##  ##                  
################################
