################################
        ##        ##      ##  ##
##  ##  ##  ####      ##  ##  ##
##  ##  ##  ##  ##  ####      ##
##  ##  ##      ##  ##  ####  ##
##  ##      ######  ##        ##
##  ########        ##  ##  ####
####          ####    ##  ######
##    ######      ####      ####
####  ##    ##  ##      ##    ##
##    ##  ####  ##  ####  ##  ##
##  ##          ####  ##  ##  ##
##    ######  ##              ##
##  ##      ####  ##############
##      ##                      
################################
