################################
      ##        ##      ##    ##
##  ##    ####      ##      ####
##  ####      ####  ##  ####  ##
##      ##  ##  ##    ##      ##
##  ##      ##  ####      ##  ##
##    ######      ##  ####    ##
####      ##  ##    ##    ##  ##
##  ####    ##  ##      ##    ##
##  ##  ##          ##    ##  ##
##        ##  ##  ##  ####    ##
####  ####    ####          ####
####        ##      ######  ####
##    ######    ####          ##
##  ##        ##      ##  ##    
################################
