################################
                  ####    ##  ##
##  ######  ####        ##    ##
##  ##  ##  ##  ##  ##  ##  ####
##  ##  ##        ##        ####
##      ########    ######    ##
######          ##  ##  ##  ####
##  ##  ##  ####    ##  ##    ##
##        ##      ##        ####
##  ##  ##    ####    ##  ##  ##
####      ##  ####  ##    ##  ##
##    ####        ##    ####  ##
##  ##    ######  ##  ##      ##
##  ####      ##  ##      ##  ##
##      ####        ##  ##      
################################
