################################
          ##  ##              ##
##  ####        ######  ####  ##
####    ##  ##      ##  ##    ##
##    ####    ####  ##  ##  ####
####      ##    ##      ##    ##
##  ####      ##  ######  ##  ##
##      ######        ##  ##  ##
####  ####      ####      ##  ##
####        ##      ####  ##  ##
##    ##  ##  ####  ##    ##  ##
####    ##      ##  ########  ##
##  ##    ##  ####            ##
##  ####      ##  ##############
##        ##                    
################################
