################################
          ##  ##          ##  ##
##  ####        ####  ##      ##
##  ####  ####        ######  ##
##      ##    ####  ##    ##  ##
##  ##    ##          ##  ##  ##
##  ####  ##  ##########      ##
##    ##  ##  ##        ########
####  ##  ####    ####        ##
####  ##        ##      ####  ##
##  ##    ##  ####  ########  ##
##    ####    ##        ##    ##
####      ##    ##########  ####
##  ####  ######            ####
##                ####  ##      
################################
