################################
    ##            ##      ##  ##
##      ##  ####      ##  ##  ##
##  ####  ##    ##  ##        ##
##            ##    ##  ##  ####
##  ##########    ##    ##    ##
####          ##    ##    ##  ##
####  ######    ##    ##    ####
##    ##  ##  ######    ##    ##
####  ##  ##    ##  ##    ##  ##
##    ##    ##        ##  ##  ##
##  ##    ######  ##  ##    ####
##    ##    ##  ##  ######    ##
####    ##            ####  ####
######      ####  ##            
################################
