################################
          ##    ##      ##    ##
##  ####    ##      ##  ####  ##
##  ######  ##  ####      ##  ##
##    ##  ####  ##  ##  ##    ##
####  ##  ##    ##  ##      ####
##    ##      ##      ####  ####
##  ##  ########  ##  ##      ##
##                ##    ##  ####
##  ####  ######    ######    ##
######    ##      ##        ####
##      ##  ########  ######  ##
##  ####              ##      ##
##        ##  ########  ##  ####
##  ##  ##                      
################################
