################################
                ##        ##  ##
####  ##  ######    ####  ##  ##
##    ##      ######      ##  ##
##  ########      ##  ##  ##  ##
##    ##    ####    ##    ##  ##
####      ##    ##      ##    ##
##  ####    ##    ####    ##  ##
##      ##  ####      ##  ##  ##
##  ##  ##        ##    ##    ##
##    ######  ########      ####
####    ##  ##    ##  ####    ##
######          ##        ##  ##
####    ####  ##    ####      ##
##    ##          ##      ##    
################################
