################################
            ##          ##    ##
####  ##  ####  ####  ##    ####
##      ##        ##      ##  ##
####  ##    ########  ##      ##
####      ##          ##  ##  ##
##    ######  ########  ##    ##
##  ####      ##          ##  ##
####      ####    ######  ##  ##
##  ##  ##  ##  ##    ##      ##
##    ##        ##  ##  ########
##  ##    ########            ##
##  ##  ####        ##  ##  ####
##          ########  ##      ##
##  ##  ##                ##    
################################
