################################
            ##                ##
##  ######      ##  ########  ##
##  ##    ######    ##        ##
##      ####      ##  ##  ######
##  ####      ####        ##  ##
####      ####  ##  ########  ##
##  ######  ##      ##        ##
##  ##      ##  ####    ####  ##
##      ##  ##  ##    ##  ##  ##
##  ##    ####      ####      ##
##    ##      ######      ######
####    ####        ##  ##    ##
##  ##  ##    ######      ##  ##
##        ##          ##        
################################
