################################
        ##  ########          ##
##  ####      ####    ##  ##  ##
##  ##    ##        ##      ####
##      ##  ####  ##    ##    ##
##  ######      ##  ####  ##  ##
##  ##      ####              ##
##      ####  ##  ######  ##  ##
##  ##  ##        ##    ##    ##
##    ##    ######  ##      ####
##  ####  ####  ##      ####  ##
####      ##    ##  ####      ##
##    ####    ##        ####  ##
##  ##  ##  ##  ##  ##    ##  ##
##          ##        ##        
################################
