################################
      ####      ##            ##
####        ##    ##  ######  ##
##    ######  ##  ##        ####
##  ####      ##  ##  ####    ##
##  ##    ##  ##    ##  ##  ####
##  ##  ####    ##  ##        ##
##    ##      ##    ##  ####  ##
####  ##  ####    ##      ##  ##
##    ##      ##  ##  ##    ####
##  ##    ##  ##  ##  ####    ##
##  ##  ##      ##        ##  ##
##  ##  ####  ############    ##
##  ####      ####          ####
##        ##        ##  ##      
################################
