################################
    ##  ##  ##                ##
##          ##  ##########  ####
##  ##  ####    ##      ##    ##
##  ##  ##    ##    ####    ####
####    ##  ##    ######  ##  ##
##    ####  ##  ######        ##
##  ####          ##    ##  ####
##        ##  ####    ####    ##
####  ##    ##      ##    ##  ##
##    ##  ##    ########      ##
##  ##  ##    ##    ##    ######
##  ##  ##  ##  ##    ##  ##  ##
##  ##  ##  ##  ####  ##  ##  ##
##      ##  ##                  
################################
