################################
            ##      ##        ##
##  ######      ######  ##  ####
##  ##      ##  ##      ##  ####
##  ##  ##    ##    ####  ##  ##
##  ##    ##  ##  ##          ##
##    ##  ##  ##  ##  ##########
########  ##  ##  ##          ##
##        ##  ##  ##  ##  ##  ##
##  ##  ####  ##    ##  ##    ##
##  ####        ##      ##  ####
##      ##  ####  ####  ##    ##
##  ##    ##        ##  ####  ##
##    ##      ##  ##      ##  ##
####    ##  ##        ##        
################################
