################################
        ##  ##              ####
##  ##  ##    ##  ####  ##    ##
####    ####    ##      ####  ##
##    ##    ##      ####      ##
####      ######  ####  ##  ####
##    ##    ##    ##    ##    ##
####    ##      ##    ##  ##  ##
##    ##  ######  ##  ##      ##
##  ##    ##          ##  ######
####    ##    ######  ##  ##  ##
##    ##    ####  ##      ##  ##
##  ##    ####      ######    ##
##      ##      ##        ##  ##
##  ##      ##    ##  ##        
################################
