################################
      ####  ##        ##    ####
##  ##          ####    ##    ##
##  ##  ##  ####    ##    ##  ##
##  ##  ####    ##  ####      ##
##  ##      ##        ####  ####
##    ######    ####    ##    ##
####  ##    ##  ##  ##    ##  ##
##        ####  ##    ##      ##
##  ####        ####    ########
##      ##  ####      ##      ##
######    ##      ##  ##  ##  ##
##    ##  ##  ####    ####    ##
####          ####  ##  ##  ####
##    ####  ##                  
################################
