################################
            ####        ##    ##
##  ##  ##        ####      ####
####  ##    ##  ##      ##    ##
##      ######  ##  ##  ########
##  ##          ##  ####      ##
##    ########    ##      ##  ##
####          ####    ##  ##  ##
##    ######        ####  ##  ##
##  ##      ########      ##  ##
##      ##  ##      ##  ##    ##
##  ##  ####    ##  ########  ##
##    ##      ####      ##    ##
####  ##########  ####    ##  ##
##                    ##        
################################
