################################
              ##      ##      ##
##  ########  ##  ##      ##  ##
##  ##        ##    ####  ##  ##
##    ######    ##    ##    ####
##  ##      ##    ##    ##    ##
##      ##    ####    ##    ####
##  ####  ##        ####  ##  ##
##    ##  ######  ##          ##
####  ##        ##    ##########
##    ##  ####  ##  ####      ##
####  ##  ##    ##        ##  ##
##    ##  ##  ##  ##  ######  ##
####  ######      ####        ##
##            ##      ##  ##    
################################
