################################
    ##    ##      ####        ##
##      ##    ##        ##  ####
##  ####    ##  ####  ##      ##
##      ##  ##      ##    ##  ##
##  ##      ##  ##    ##    ####
##    ######    ####    ##    ##
##  ##        ##    ##    ##  ##
##  ##  ######    ######  ##  ##
##  ##  ##      ##  ####  ##  ##
####    ####  ##          ##  ##
##  ####      ##  ##########  ##
##    ##  ##  ##              ##
##  ##      ##  ############  ##
##      ##                      
################################
