################################
      ##      ##  ####  ##    ##
##  ##    ##                ####
##    ##  ##  ####  ######  ####
####        ####    ##        ##
##    ######      ##  ##  ##  ##
####      ##  ####      ####  ##
##  ####  ##    ##  ##        ##
##    ##    ##  ##    ##  ##  ##
##  ######  ##    ##    ##    ##
##    ####  ####    ##    ##  ##
####          ####    ##    ####
######  ######      ##  ##    ##
####  ##        ####    ##  ####
##        ####      ##          
################################
