################################
          ####          ##    ##
##  ####        ##  ##    ##  ##
##  ##  ####  ##  ##  ##      ##
##  ##      ##          ####  ##
##  ##  ##    ##  ####  ####  ##
##  ##    ##    ######        ##
##  ##  ##  ##    ##    ########
##  ##  ##    ##    ##        ##
##  ##    ##  ####  ########  ##
##    ######    ##        ##  ##
####  ##      ##    ####      ##
##    ##  ########  ######  ####
##  ##    ##  ##      ##  ##  ##
##      ##        ##            
################################
