################################
    ##              ##        ##
##    ##  ##  ##  ##    ########
####    ####    ####  ##      ##
##  ##        ##      ##  ##  ##
##  ##  ##  ##    ####      ####
##      ##    ##      ####    ##
##  ####  ##    ####    ##  ####
##  ##      ##  ##  ##      ####
##    ####  ##      ######    ##
####          ##  ##      ##  ##
############  ##  ##  ##      ##
####      ##  ##  ##    ##  ####
##    ##  ##  ##  ##  ##  ##  ##
##  ##        ##                
################################
