################################
    ##  ##                ##  ##
##          ##  ##  ####      ##
##  ##  ####  ####      ####  ##
##  ####          ####    ######
####      ##  ##  ##  ##      ##
##    ####  ##    ##  ######  ##
######      ##  ##            ##
##  ####  ##    ######  ####  ##
##    ##    ##          ##    ##
####      ##  ####  ####    ####
##    ##      ##  ##    ##    ##
##  ##  ##  ##        ##    ####
##      ##  ##  ##  ####  ##  ##
##  ##  ##      ##              
################################
