################################
                ##            ##
##  ######  ##      ##  ####  ##
##  ##    ##  ########    ##  ##
##  ##  ##              ##    ##
##      ##  ########  ##    ####
####  ##  ####      ##    ##  ##
######        ##  ####  ####  ##
####    ####      ##    ##    ##
##    ####    ####    ##    ####
##  ####    ##      ##    ##  ##
##      ##  ##  ##  ##  ##    ##
##  ##  ####    ####        ####
##  ##    ##  ##      ####    ##
##    ##          ##      ##    
################################
