################################
      ##            ##        ##
####      ########      ########
##    ####      ####  ##      ##
##  ##  ##  ##    ##      ##  ##
##        ######    ########  ##
########    ##    ##          ##
##      ##    ##    ##  ########
##  ##    ##      ######      ##
##    ####  ####    ####  ##  ##
####        ##  ##        ##  ##
####  ####        ######  ##  ##
##    ##  ##  ####      ##    ##
##  ##    ##        ##    ##  ##
##      ##    ##  ######        
################################
