################################
    ##            ##  ##  ##  ##
##  ##  ########              ##
##  ##  ##        ##  ######  ##
##  ##  ##  ######  ##        ##
##      ##  ##          ########
######  ##  ####  ##  ##      ##
##    ##        ##    ##  ##  ##
####    ##  ##    ##  ##  ##  ##
######  ##  ##  ##      ####  ##
####    ##  ##    ####        ##
##    ######  ##    ##  ####  ##
####  ####        ##      ##  ##
##          ######    ##    ####
##  ####  ##        ######      
################################
