################################
    ##      ##  ##    ##      ##
##  ##  ##        ##      ##  ##
##  ##    ##  ##      ##  ##  ##
##  ####  ##    ####    ##    ##
##    ##  ####  ##  ####    ####
####        ##          ####  ##
##  ########    ##  ##        ##
##          ##    ##  ####  ####
####  ####    ##  ##    ##    ##
##  ##  ##  ####      ######  ##
##  ##  ##      ####    ##    ##
##        ####    ##  ##    ####
##  ######  ####  ######  ##  ##
##                              
################################
