################################
        ##  ##          ##  ####
##  ##  ##  ##  ######        ##
##    ##    ####      ######  ##
####      ##      ##          ##
####  ####    ####  ####  ##  ##
##          ##      ##  ##    ##
##  ########    ##      ##  ####
####      ##  ##    ######    ##
##    ####    ####  ##      ####
##  ##      ##      ##  ####  ##
##  ##  ##  ##  ##  ##  ##    ##
##    ##    ##    ####  ####  ##
####  ##  ##  ##  ##      ##  ##
##            ##      ##        
################################
