################################
      ##            ##        ##
##  ##    ####  ##      ##  ####
##  ####  ##      ########    ##
##        ##  ####        ##  ##
##  ######    ##    ##  ##    ##
##  ##  ##  ##    ##      ##  ##
##      ##  ####    ########  ##
##  ##  ##    ##  ##          ##
##  ##    ##  ##  ##  ##########
####    ##    ##  ##  ##      ##
##    ##    ##            ##  ##
####  ####  ##  ####  ##  ##  ##
##      ##    ##    ##      ####
##  ##    ##      ##    ##      
################################
