################################
              ##  ##  ##      ##
##  ##  ####            ####  ##
##    ##    ##  ######    ##  ##
####      ####        ##      ##
##  ####      ######  ######  ##
##      ####      ##      ##  ##
##  ##      ####  ##  ##    ####
##    ####  ##      ##  ##  ####
####  ##  ##    ##      ##    ##
##        ##  ########  ####  ##
######  ##      ##  ##    ##  ##
##      ##  ##  ##    ##  ##  ##
##  ####      ##  ##    ####  ##
##        ##        ##          
################################
