################################
                ##    ##      ##
##  ####  ####    ##      ##  ##
##  ##        ##  ##  ####    ##
####    ##  ####  ##  ######  ##
##    ######      ##    ##    ##
##  ##  ##    ##    ##    ##  ##
##      ##  ##    ##  ##  ##  ##
######  ##    ##      ##  ##  ##
##      ####  ##  ####    ##  ##
##  ####      ##      ##  ##  ##
##    ##  ##    ##########    ##
##  ##      ####      ##    ####
##    ####  ####  ##  ##  ##  ##
####    ##        ##            
################################
