################################
            ####          ##  ##
##  ######        ########    ##
##        ##  ####          ####
##########    ##    ####  ##  ##
##          ##    ##          ##
##  ######  ####    ####  ######
##      ##      ##    ##      ##
##  ##  ##  ####    ##  ####  ##
######    ##      ####  ##    ##
##      ####  ######    ##  ####
##  ####      ##      ##    ####
##      ##  ##  ##  ##  ##    ##
##  ##  ##  ##  ##        ##  ##
##  ##              ####  ##    
################################
