################################
        ##  ##      ##  ##    ##
##  ####        ##          ####
##    ##  ######  ##  ######  ##
####          ##  ##  ##      ##
##    ######      ##      ##  ##
##  ##      ######    ####    ##
##  ##  ##        ####      ####
####    ##  ####  ##    ##    ##
##    ##  ##          ##  ##  ##
##  ####      ##  ######      ##
##  ##    ########      ##  ####
##  ####      ##    ##    ##  ##
##      ########  ##  ##      ##
##  ##            ##      ##    
################################
