################################
          ####        ##      ##
##  ####      ######      ##  ##
##    ######      ##  ####    ##
####        ####      ######  ##
##    ####      ######  ##    ##
####    ##  ##      ##      ####
##  ##    ########    ##  ##  ##
##  ####    ##  ####    ##    ##
##      ##  ##      ##      ####
##  ##      ##  ##  ##  ##    ##
##    ######  ##    ##    ##  ##
####      ##      ##  ##    ####
##  ####  ####  ##      ##    ##
##                  ##    ##    
################################
