################################
      ##  ##  ##      ##      ##
##  ##            ##  ####  ####
##      ##  ########        ####
##  ####    ##      ######    ##
##    ##  ##    ##      ####  ##
##  ##      ##  ######    ##  ##
##  ##  ####          ##    ####
##  ##        ####  ##  ##    ##
##    ##########          ##  ##
####  ##        ##  ##  ##    ##
##    ##  ####  ######  ##  ####
##  ##    ##          ##      ##
##  ####  ##  ######  ######  ##
##    ##    ##                  
################################
