################################
      ##  ##      ##      ##  ##
##  ##      ##  ##    ##  ##  ##
##      ##          ####  ##  ##
####  ##  ##  ##  ##      ##  ##
##    ##        ##    ######  ##
##  ##    ##  ##  ##          ##
####    ##    ##    ########  ##
##    ##  ##  ####        ##  ##
##  ##          ########  ##  ##
##    ####  ##        ##    ####
####      ##  ########  ##    ##
####  ##  ##              ##  ##
##    ##    ##  ##  ########  ##
##  ######      ##              
################################
