################################
      ##        ##  ##        ##
####      ####        ####  ####
##    ####    ##  ##  ##      ##
##  ########  ##  ##    ####  ##
##    ####    ##    ##        ##
####        ######    ##  ##  ##
##  ######    ####  ##  ##    ##
##  ##      ##      ##    ##  ##
##      ####    ####  ##      ##
##  ######    ######      ######
####      ##  ####    ####    ##
####  ####        ##  ##    ####
##        ######  ##  ##  ##  ##
##  ####          ##            
################################
