################################
        ##          ##      ####
##  ##      ######  ##  ##    ##
##    ######    ##  ##    ##  ##
####  ##    ##  ##    ##  ##  ##
####  ####  ##  ##  ##  ##    ##
##  ##          ##      ##  ####
##      ##  ##  ##  ####      ##
##  ##  ##  ######        ##  ##
####      ##      ##  ##  ##  ##
####  ##  ##  ##    ##  ##    ##
##      ##      ##      ##  ####
##  ####    ####    ####    ####
##  ####  ##  ##  ##      ##  ##
##            ##      ##        
################################
