################################
      ##        ##  ##      ####
####      ##  ##        ##    ##
##    ##    ####  ##  ##  ######
####    ####      ##  ##      ##
##  ##  ##    ##  ##      ##  ##
##          ######  ####  ##  ##
##  ##  ##    ##        ##    ##
##    ##  ####    ####  ##  ####
####  ##        ######    ##  ##
####    ##  ####  ##  ##      ##
##  ##  ##    ##      ##  ##  ##
##        ##    ##  ##      ####
##  ####      ##        ##    ##
##      ##  ##    ##  ######    
################################
