################################
          ##      ##          ##
######  ##    ##    ##  ####  ##
##          ######  ##  ##    ##
##  ####  ##  ####  ##    ##  ##
##    ##  ##            ##    ##
####    ##    ##########    ####
##  ##    ##  ##      ##  ##  ##
##    ##  ##  ##  ##  ##      ##
####      ##  ##  ##    ########
##    ##  ##  ##  ####        ##
####  ##  ######    ####  ##  ##
##    ##          ##    ####  ##
##  ##  ##########  ##        ##
##                    ##  ##    
################################
