################################
      ##              ##    ####
####    ##  ####  ##    ##    ##
##  ##          ##  ##    ##  ##
##  ##  ##  ##      ####      ##
##        ##    ##      ##  ####
####  ##    ####  ##  ####    ##
##      ##        ##  ##  ##  ##
##  ##  ########  ##  ##      ##
##    ##      ######    ##  ####
##  ##    ##        ##  ##  ####
####    ##########      ##    ##
##    ##  ##      ##  ##    ####
##  ##    ##  ##    ####  ##  ##
##    ##        ##              
################################
