################################
      ##              ##  ##  ##
##  ##    ####  ######        ##
##    ##    ##          ####  ##
##  ##  ##  ####  ##  ##      ##
##              ####    ####  ##
##  ####  ######      ##    ####
##      ##        ##    ##    ##
########    ########  ##  ##  ##
##        ####      ##        ##
##  ##  ####    ##      ########
##  ####      ##  ##  ##      ##
##        ####      ##    ##  ##
##  ######      ##  ##  ####  ##
##          ####        ##      
################################
