################################
            ##    ##      ##  ##
####  ##  ##    ##    ##      ##
##      ##    ##    ##    ##  ##
##  ##      ##    ##    ##    ##
##    ##  ####  ##  ##  ##  ####
####  ##  ##    ##  ##  ##    ##
##  ##    ##  ####  ##  ####  ##
##      ####        ##    ##  ##
##  ##      ####  ##  ##    ####
##  ##  ##              ##    ##
####      ##################  ##
##    ##  ##            ##    ##
####  ####    ########  ##  ####
##        ####                  
################################
