################################
            ##          ##    ##
##  ##  ##    ##  ####      ####
##  ##    ##  ##      ##  ##  ##
######  ##    ######  ##      ##
##      ##  ##          ####  ##
##  ######  ##  ######    ##  ##
##  ##      ##        ####    ##
##  ##  ####  ##  ##    ##  ####
##    ##      ####    ##  ##  ##
####  ##  ##        ##        ##
##    ##    ########  ##  ##  ##
####    ##        ##      ##  ##
######    ##  ##    ########  ##
########        ##              
################################
