################################
        ##                    ##
####  ##    ##  ######  ####  ##
##        ##  ##      ##      ##
####  ####        ##    ##  ####
##    ##  ########  ##  ##    ##
####  ##            ##      ####
##    ##  ####  ##    ######  ##
##  ##        ######  ##      ##
##  ##  ####    ####      ##  ##
##    ##    ##      ########  ##
####      ##  ######          ##
##  ####            ##  ##  ####
##      ##########  ##  ##    ##
##  ##                    ##    
################################
