################################
    ##          ##            ##
##      ####  ##    ######  ####
##  ####      ##  ####  ##    ##
######    ##  ##          ##  ##
##      ##    ########  ##    ##
##  ####    ##      ##  ##  ####
##      ##    ##  ##    ##    ##
##  ##    ##      ##  ######  ##
##    ##    ##  ##      ##    ##
####  ##  ######    ##  ##  ####
##    ##    ##    ########    ##
##  ######    ##  ####    ##  ##
##  ####  ##          ##      ##
##          ##  ####    ####    
################################
