################################
    ##        ##  ##    ##    ##
##      ####  ##    ##    ##  ##
##  ####        ##    ##      ##
##  ##  ##  ####    ##  ####  ##
##  ##  ##  ##    ##          ##
##      ##      ####  ##  ##  ##
######  ##  ####      ##  ##  ##
##  ##    ##      ####  ##    ##
##    ##  ##  ####          ####
####  ##  ##      ##  ##########
##    ##  ##  ##  ##        ####
##  ##      ####    ##  ##    ##
##  ##  ####      ##  ####  ####
##            ####              
################################
