################################
        ##    ##  ##      ##  ##
##  ####    ##      ####      ##
##        ##    ##    ##  ##  ##
##  ##  ##    ##  ######  ##  ##
####      ##      ##      ##  ##
##    ##    ####  ####  ##    ##
####  ######  ##        ##  ####
####          ####  ######    ##
##    ######      ##      ##  ##
##  ####    ####    ####  ##  ##
##  ##    ##    ##        ##  ##
##  ##  ##    ##  ##  ######  ##
##  ##      ##    ##          ##
##      ##      ##    ##  ##    
################################
