################################
    ##      ##  ##      ##    ##
##  ##  ##          ##      ####
##  ##    ######  ##  ####    ##
##    ####      ##        ##  ##
##  ####  ##  ##    ####      ##
##            ##  ##    ####  ##
######  ##  ##    ####      ####
##        ##    ##  ##  ##    ##
##  ##  ##    ##    ##  ####  ##
##    ####  ######  ##    ##  ##
####          ##        ##    ##
####  ##  ##    ########    ####
##      ##  ##        ##  ##  ##
##  ##        ##  ##            
################################
