################################
                  ##          ##
##  ######  ##  ##    ##  ##  ##
##  ##    ##    ##  ##    ##  ##
##    ##      ##    ##  ##    ##
####  ##  ######  ####  ##  ####
##      ##        ##    ##  ####
##  ##      ######    ##      ##
##    ######    ##  ##  ##  ####
####      ####  ##  ##        ##
##  ####        ##  ########  ##
##  ##    ########          ####
##      ##        ########    ##
####  ##    ####  ##        ####
##    ##  ##          ####      
################################
