################################
        ##        ####        ##
##  ##      ####        ####  ##
##    ######    ####  ##      ##
##  ##        ##  ##    ####  ##
##      ####        ##      ####
##  ##  ##    ##  ##  ####    ##
##    ##    ##  ##          ####
####    ##  ##      ########  ##
##  ##    ##    ######        ##
##    ####    ##        ####  ##
####        ##    ##  ##  ##  ##
##    ####  ####  ####        ##
##  ##  ####        ##  ####  ##
##            ####  ##  ##      
################################
