################################
      ####    ##          ######
####        ##    ##  ##    ####
##    ##  ##    ##      ##    ##
##  ##      ##  ##  ##  ####  ##
####    ####      ##  ##      ##
##    ####    ####        ##  ##
##  ##      ##      ######    ##
##    ####    ####      ####  ##
####      ##      ####      ####
##    ##    ####      ####    ##
####    ##      ####      ##  ##
##  ##  ##  ####      ##  ##  ##
##  ##  ##  ##    ####  ####  ##
##      ##      ##              
################################
