################################
              ##  ##          ##
##  ##  ##  ##        ######  ##
##    ##  ##    ##  ##    ##  ##
####  ##      ##    ##  ##    ##
##      ####  ##  ##        ####
##  ##        ##    ##  ####  ##
##    ##  ##  ####    ##      ##
##  ##  ####      ##      ##  ##
##  ##      ######  ##  ##    ##
##  ##  ##  ##        ##    ####
##    ##    ##  ####      ##  ##
##  ##    ##    ##  ####      ##
##  ##  ##  ##  ##      ####  ##
##  ##          ##  ##          
################################
