################################
    ####              ##      ##
##        ####  ####  ##  ##  ##
####  ##      ##  ##  ##    ####
##      ##  ##    ##    ##    ##
##  ##    ##    ##  ##      ####
##    ##  ##  ##      ####    ##
##  ####  ##    ##  ##  ####  ##
####        ##                ##
####  ##  ##    ################
##      ##  ##  ##            ##
##  ####    ##    ####  ####  ##
##    ##  ##  ##      ##      ##
####      ##      ##      ##  ##
##    ####    ##    ##  ##      
################################
