################################
                ##    ##  ##  ##
####  ##  ####      ##        ##
##    ##      ##  ##    ####  ##
##  ####  ####    ##  ##      ##
####      ##    ####    ########
##    ##  ######      ##      ##
####  ####      ##  ##  ##  ####
####        ##  ##      ##    ##
##    ##  ##    ######      ####
##  ##    ####        ####    ##
####    ##    ##  ##      ##  ##
##    ##  ##    ##    ######  ##
####      ####  ##  ####      ##
##    ##        ##        ##    
################################
