################################
    ##        ##      ####    ##
##  ##  ####    ####      ##  ##
##  ##  ##  ##      ####      ##
##      ##    ####      ####  ##
##  ####  ##      ####        ##
##    ##      ##  ##########  ##
####    ##  ##      ##      ####
##  ##  ####  ####      ##    ##
##  ##            ######  ##  ##
##  ########  ##  ##      ##  ##
##          ####      ##      ##
##  ######      ##  ##  ##  ####
##        ####    ##          ##
####  ##      ##      ##  ##    
################################
