################################
      ####  ##        ##  ##  ##
####        ##  ####          ##
##    ##  ##    ##    ######  ##
##  ##        ##  ##  ##      ##
##  ##  ######    ##  ####  ####
##    ##    ####  ##      ######
####    ##          ####  ######
##  ##    ######  ##  ##    ####
##    ##      ##        ##    ##
##  ##  ####  ##  ######  ##  ##
##      ####  ##          ##  ##
####  ##        ####  ####    ##
####      ######      ##    ####
##    ##          ##    ##      
################################
