################################
    ##  ##      ##  ##  ##    ##
##      ##  ##              ####
##  ##      ####  ####  ##    ##
##  ##  ####      ##  ######  ##
##    ##      ####      ##    ##
##  ##    ##  ####  ##  ##  ####
##    ##    ##      ##  ##  ####
####  ####      ####    ##    ##
##        ##########  ##  ##  ##
##  ####        ##    ##  ##  ##
####    ####  ##    ##    ##  ##
##    ##  ##  ##  ##  ##  ##  ##
##  ##      ##    ##      ##  ##
##      ##      ##    ##        
################################
