################################
              ##  ##          ##
##  ##  ##  ##        ######  ##
####    ##  ##  ######        ##
##    ####  ##        ##  ##  ##
##  ##      ########    ####  ##
##    ####          ##      ####
####  ##  ########  ##  ##  ####
##    ##  ##    ##  ##  ##    ##
####  ##      ####    ######  ##
####    ##  ##    ##    ##    ##
##  ####      ##    ##      ####
##        ##    ##  ####  ######
##  ######  ##              ####
##            ##  ##  ####      
################################
