################################
        ##  ##      ##        ##
####  ##      ####      ####  ##
##        ##    ####  ####    ##
##  ######  ##      ##      ####
##  ##        ####      ##    ##
##  ##  ####      ######  ##  ##
####        ##  ##        ##  ##
##    ##  ##        ####  ##  ##
##  ##  ##    ####      ####  ##
##  ##    ##      ######      ##
##    ##  ##  ####        ######
##  ##    ##  ##    ########  ##
##      ####    ##  ##        ##
##  ##      ##          ####    
################################
