################################
            ######            ##
##  ######    ##    ##  ####  ##
##  ##    ##  ##########  ##  ##
##    ##            ##        ##
####    ##  ##  ##      ####  ##
##  ##    ##  ##    ######    ##
##  ####  ##      ##      ##  ##
##          ##  ##    ##  ##  ##
##  ######  ##  ##  ##    ##  ##
######      ######    ##    ####
##      ####        ######    ##
##  ####      ######  ##    ####
##      ##  ####  ##    ##  ####
##  ##                ##        
################################
