################################
            ####        ##    ##
##  ##  ####      ####    ##  ##
##    ##      ####    ####    ##
##  ##    ####      ##      ####
##  ##  ##  ##  ##    ##  ##  ##
##  ##  ##        ##      ##  ##
##  ##  ##  ####    ####      ##
##  ##  ##    ####  ########  ##
##  ##    ##    ##    ##      ##
##    ##  ####    ##  ##  ######
##  ##        ####    ##      ##
##    ######        ##  ####  ##
##  ##      ####  ##    ####  ##
##      ##          ##          
################################
