################################
      ##  ##          ##    ####
####        ####  ##    ##    ##
####  ####          ##    ##  ##
##    ##  ####  ##  ##  ####  ##
####        ##    ##          ##
##  ######  ####    ########  ##
##  ##  ##      ##  ##        ##
##        ####  ##    ##  ##  ##
####  ##    ##    ##    ##    ##
##      ####  ##    ##  ##  ####
##  ##            ##    ##  ####
##############  ##    ##      ##
##  ##        ####  ##    ##  ##
##      ####        ##  ##      
################################
