################################
              ##        ##    ##
##  ##  ##  ##    ####    ##  ##
##  ####  ##########    ##    ##
##          ##        ##  ##  ##
##  ######    ##  ####        ##
##  ##    ##      ##  ####  ####
##    ##    ######      ##    ##
####    ##  ##      ##      ####
##  ##        ##  ##    ##    ##
##  ####  ##  ##    ##    ##  ##
##      ##    ####    ####    ##
##  ##  ##  ##    ##  ##    ####
##  ##        ##  ##    ##  ####
##    ##  ##          ##        
################################
