################################
      ####                ##  ##
##  ##      ####  ##  ##      ##
##      ##      ##  ####  ##  ##
########  ##  ##        ##    ##
##        ####    ####    ##  ##
##  ##  ##      ##      ##    ##
##  ##      ####    ####    ####
##    ##########  ##      ######
##  ##      ##    ##  ##  ######
##    ##  ####  ##    ##    ####
##  ####        ##  ######    ##
##      ########    ####    ####
##  ##        ##  ##      ##  ##
##    ##  ##      ##  ##        
################################
