################################
                      ##      ##
##  ##  ########  ##  ##  ##  ##
##  ####        ##      ##    ##
##        ####  ##  ##      ####
##  ##########  ##    ######  ##
####      ##    ##  ##        ##
####  ##  ##  ######    ####  ##
##    ##  ##    ##    ######  ##
##  ##      ##      ##  ##    ##
##  ##  ####    ####        ####
##    ##      ##  ##  ####    ##
####    ####      ##  ##    ####
##  ##      ######    ##  ##  ##
##      ##          ##          
################################
