################################
        ##            ##      ##
##  ####  ##  ####  ##    ##  ##
##        ##  ##    ##  ##  ####
##  ##  ##    ##  ##          ##
####    ##  ##    ####  ####  ##
##    ##    ##  ##        ##  ##
##  ##  ##  ##    ########    ##
##  ##        ##            ####
##  ##  ##  ##  ##########    ##
##    ##    ##            ##  ##
####    ##  ##  ##  ####  ##  ##
####  ##    ##    ##      ##  ##
##      ##    ##  ##  ######  ##
##  ##      ##    ##            
################################
