################################
      ##  ####              ####
####            ####  ####    ##
##    ##  ##########      ######
##  ######      ##  ####      ##
##    ##    ##        ######  ##
####      ##  ####  ##        ##
##  ######      ##  ##  ####  ##
##      ##  ##      ##  ##    ##
##  ##      ########    ####  ##
##  ####  ##        ##      ####
##      ##  ####  ##  ####    ##
####  ##      ##        ####  ##
##        ##  ####  ##    ######
##  ##  ##            ##        
################################
