################################
      ##      ##      ##########
##  ####  ##  ##  ##    ########
##        ##  ##    ##    ######
####  ####    ##  ##  ##    ####
##    ##    ##    ##    ####  ##
########  ##    ##    ######  ##
##          ##      ##  ##    ##
##  ##############  ##      ####
##          ##  ##    ####  ####
##  ######        ##    ##    ##
##        ##  ##    ##    ##  ##
####  ##  ##  ##  ##  ##      ##
##  ##    ##  ####      ##  ####
##      ##          ##          
################################
