################################
    ##          ##            ##
##      ##  ##    ######  ##  ##
##  ####    ####          ##  ##
######    ##    ####  ####    ##
##      ##    ##    ##      ####
##  ####  ##    ##      ####  ##
##  ##      ##      ######    ##
##    ##  ##    ######      ####
####  ##      ##        ####  ##
##      ##  ##    ######      ##
##  ##    ##    ##      ##  ####
##  ####  ##  ####  ##      ####
##    ##          ##    ##    ##
####    ##  ####      ######    
################################
