################################
    ##    ##      ##  ##      ##
##      ####  ##          ##  ##
##  ##          ##  ##  ##    ##
##    ########  ##    ##    ####
####          ##    ##    ##  ##
########  ##    ##  ######    ##
####      ####  ##          ####
##    ##      ##  ##  ##  ######
##  ######  ##      ##    ######
##  ####  ####  ##  ####    ####
####            ##    ####    ##
##    ########    ##      ##  ##
##  ##      ######  ####      ##
##      ##              ####    
################################
