################################
        ##                    ##
##  ##  ##  ##  ####  ######  ##
##  ##      ####    ##        ##
##  ##  ####      ####  ####  ##
##    ##      ####      ##    ##
##  ##    ####      ####    ####
##  ##  ##  ##  ####    ########
##  ##  ##          ##      ####
##  ##  ##  ######  ##  ##    ##
##  ##  ##      ##        ##  ##
####    ##  ##    ##  ####    ##
####  ####    ##    ##      ####
##        ####  ######  ##    ##
##  ####                  ##    
################################
