################################
    ##    ##        ##        ##
##  ####      ####    ##  ######
##      ##  ##  ####  ##      ##
####  ##    ##        ##  ##  ##
##    ####    ##  ####    ##  ##
##  ##      ##    ##  ##  ##  ##
##    ##  ##  ##        ##    ##
####  ##  ##  ##  ####  ##  ####
##    ##  ##    ##      ##    ##
##  ##      ##    ##  ##    ####
##  ######  ####  ##    ##    ##
##      ##    ##    ##    ##  ##
##  ##    ##  ##  ##  ##  ##  ##
##    ##      ##                
################################
