################################
        ##  ##                ##
##  ####        ##  ########  ##
##    ##  ##  ####          ####
####        ##    ##  ####    ##
##    ######    ##  ##  ##  ####
####  ##      ##        ##    ##
##    ##  ##      ######    ####
####      ########      ##    ##
##  ##  ##          ##    ##  ##
##      ##  ##  ##  ##  ####  ##
##  ##  ##    ##  ##    ##    ##
##    ##    ##        ##    ####
####    ##    ##########  ##  ##
######    ##                    
################################
