################################
  ##    ##      ####          ##
##    ##    ##        ##  ##  ##
##  ##    ##  ########    ##  ##
##  ##  ##            ##    ####
##      ##  ##  ####    ##  ####
####  ####  ##      ##  ##    ##
##    ##      ##  ######  ##  ##
####    ######      ##        ##
##  ##      ##  ##  ##  ####  ##
##  ##  ##      ####    ##    ##
##      ####  ##      ####  ####
##  ####    ##    ##  ##      ##
##    ##  ##    ##  ##    ##  ##
####  ##      ##        ##      
################################
