################################
                  ##          ##
##  ##  ##  ####    ##  ####  ##
##    ####      ##      ##    ##
####      ####    ######    ####
############    ##    ##  ##  ##
####          ##    ##    ##  ##
##    ##  ##    ##  ##  ##    ##
##  ##  ##  ##  ##      ####  ##
##            ##    ####      ##
##  ####  ##  ##  ##      ##  ##
##      ##    ##    ##  ##    ##
####  ##    ##  ##    ######  ##
##  ####  ##      ##  ####    ##
##        ##  ##            ##  
################################
