################################
    ##    ##  ######  ##      ##
##  ##  ##      ##      ####  ##
##  ##  ##  ##      ##  ##    ##
##  ##    ##  ##  ####      ####
##  ####  ##  ##      ####  ####
##    ##        ####    ##    ##
####    ######    ##  ##  ##  ##
##  ##      ####      ##      ##
##      ##      ######    ######
####  ######  ####      ##    ##
##      ##  ##      ####  ##  ##
##  ##      ##  ####      ##  ##
##  ####  ##        ##  ##    ##
##    ##      ####          ##  
################################
