################################
  ##      ##      ##          ##
##    ##  ##  ##      ######  ##
######    ##    ##  ####      ##
##      ##    ##    ##    ##  ##
##  ##    ##    ##    ######  ##
##  ####  ##  ##  ##        ####
##    ##  ##        ##  ####  ##
####    ##  ######    ##      ##
##  ##            ##    ####  ##
##      ######  ######  ####  ##
##  ######  ##  ######        ##
##  ##      ##    ##    ##  ####
##    ##  ##  ##    ####      ##
####            ##        ##    
################################
