################################
  ##        ##  ##            ##
##    ####      ############  ##
##  ##    ####                ##
##    ##  ##  ############  ####
####          ##          ######
##  ####  ##  ##  ######    ####
##      ##    ####      ##    ##
##  ####    ##      ##  ####  ##
##        ##  ####  ##    ##  ##
##  ######      ##    ##  ##  ##
##  ##      ##      ####      ##
##    ##  ##  ##  ##    ####  ##
##  ##    ##  ##  ####    ##  ##
##      ##            ##        
################################
