################################
      ####          ##    ######
##  ##      ##  ##  ####    ####
##  ##  ##  ##  ##      ##    ##
##  ##  ####      ####    ##  ##
##  ##    ##  ####    ##      ##
##    ##  ##      ##    ####  ##
##  ####    ####    ##  ####  ##
##  ##    ##      ##          ##
##    ##    ##  ##    ##  ##  ##
####    ##  ##  ########    ####
##  ##  ##  ##          ##    ##
##            ##  ####    ##  ##
##  ##########  ##  ##  ##    ##
##          ##          ##  ##  
################################
