################################
  ####        ##  ##          ##
####    ####          ######  ##
##    ##    ##  ##  ####  ##  ##
##  ##  ##    ##    ##    ##  ##
##          ####  ##    ##    ##
##########  ##    ##  ##  ##  ##
##      ####    ##    ##  ##  ##
##  ##        ##    ##        ##
##    ####  ##  ##      ########
####      ##    ##  ####      ##
##    ##    ##      ##    ##  ##
##  ######    ##  ##  ##  ##  ##
##    ##  ##  ##      ##  ##  ##
####        ##    ##      ##    
################################
