################################
  ##              ####      ####
##    ######  ##        ##    ##
##  ##    ##    ########    ####
##  ##  ##  ##          ##    ##
##  ##      ##########    ##  ##
##      ####          ##  ##  ##
########      ######      ##  ##
##      ####  ##    ########  ##
##  ##        ##  ##          ##
##  ##  ######    ##  ##  ######
##  ####      ##      ####    ##
##    ######  ##  ####      ####
####      ##  ##  ####  ##    ##
##    ##      ##          ##    
################################
