################################
  ####            ##      ##  ##
####    ##  ####      ####    ##
##    ####  ##  ####        ####
##  ##      ##      ######    ##
##  ##  ####    ####      ##  ##
####        ##        ##  ##  ##
##    ##########  ##    ##    ##
##  ##      ##  ##  ##    ##  ##
##  ##  ##      ##      ####  ##
##      ####  ####  ##        ##
########    ##      ############
##      ##      ####          ##
##  ##    ####  ####  ######  ##
##    ##              ##        
################################
