################################
  ##  ##        ##      ##  ####
##      ####  ##    ##        ##
##  ##          ####    ####  ##
##    ########  ##    ##  ##  ##
####  ##    ##    ##      ##  ##
####    ##    ##    ####  ##  ##
##  ####    ######  ##    ##  ##
##      ##    ##    ##  ####  ##
##  ####  ##      ########    ##
##  ##        ####  ##      ####
##      ######          ##    ##
##  ####      ##  ##  ######  ##
##  ##    ##    ##    ####    ##
##      ######      ##      ##  
################################
