################################
  ##        ##    ##          ##
##    ######  ##    ##  ####  ##
##  ##          ##  ##    ##  ##
##      ######      ##  ##    ##
##  ####    ##  ####    ##  ####
##  ######    ##      ##    ####
##    ######      ####    ##  ##
####    ##  ##  ##    ##      ##
######  ##      ##  ##    ##  ##
######      ####    ##  ##  ####
####  ##  ##    ##      ##    ##
##      ##  ##    ####  ####  ##
##  ####      ##              ##
##        ##      ##  ##  ##    
################################
