################################
  ##                  ##  ##  ##
##    ######  ##  ##  ##      ##
##  ##      ##    ##  ##  ##  ##
####    ##  ##  ##        ##  ##
####  ####  ##    ####  ##    ##
##    ##      ##      ##    ####
##  ##  ####    ####    ##    ##
##  ##      ##    ####    ##  ##
##  ##  ##  ####        ####  ##
##      ##    ######  ##    ####
##  ####  ##        ##    ##  ##
##    ##    ######  ####      ##
####  ####      ##      ##  ####
##          ##    ####          
################################
