################################
  ##            ##        ##  ##
##    ########    ####  ##    ##
##  ##        ##            ####
##  ##  ##  ##    ##  ####    ##
##    ##      ####    ####  ####
####      ##    ##  ##        ##
######  ##    ##      ######  ##
####    ######    ####    ##  ##
##    ##        ####  ##    ####
##  ####  ####        ####    ##
####          ######      ##  ##
##    ##  ####      ##  ##    ##
####  ####      ##  ####    ####
##          ##  ##        ####  
################################
