################################
        ##        ##  ##      ##
####  ##    ####  ##      ######
##    ##  ##  ##  ######      ##
##  ##    ##  ##        ####  ##
##    ####    ########        ##
####      ##        ##  ####  ##
##    ##    ##  ##    ##      ##
####  ########    ##    ##  ####
##            ##  ####  ##    ##
####  ####  ####    ##    ##  ##
##    ##        ##    ##  ##  ##
##  ##  ##  ########  ##  ##  ##
##  ##  ##      ####  ##      ##
##        ####          ##  ##  
################################
