################################
  ##          ##          ######
##    ######    ####  ##    ####
##  ####    ##          ##    ##
##      ##    ##  ##########  ##
##  ##  ##  ######      ##    ##
####    ##    ##    ##      ####
##    ##    ##    ########  ####
##  ##  ##    ##    ##        ##
##  ##      ######    ##  ##  ##
##    ##  ##########    ##  ####
##  ##      ######  ##        ##
##    ####    ##      ##  ##  ##
####      ##  ##  ##    ##    ##
##    ##        ######      ##  
################################
