################################
  ######          ##          ##
######    ####  ##    ##  ##  ##
####    ##        ####    ##  ##
##    ##    ####        ##    ##
##  ##  ##      ########  ##  ##
####      ####  ##            ##
##    ##  ##    ##  ######  ####
##  ##        ##  ##      ##  ##
##  ##  ######    ##  ##      ##
##    ##        ######  ####  ##
####    ##  ##  ######    ##  ##
##    ####  ##    ##    ####  ##
##  ##        ##      ####    ##
##      ####    ####        ##  
################################
