################################
  ##  ##                  ##  ##
##    ##  ####  ##########    ##
##  ##    ####              ####
##  ##  ##    ######  ##  ##  ##
##  ##      ##      ##    ##  ##
##    ####      ####    ##    ##
####  ##  ####    ##  ##  ##  ##
##          ##  ##  ##        ##
##  ####  ##    ##  ####  ##  ##
##  ##  ##    ##          ##  ##
##          ##    ##  ####    ##
####  ##  ##  ########      ####
##      ####      ##    ##    ##
##  ##        ##      ######    
################################
