################################
                  ##          ##
##  ####  ##  ##    ##  ####  ##
####      ##    ##  ##    ##  ##
####  ##    ####    ####  ##  ##
##    ##  ##    ##    ##  ##  ##
##  ##  ######  ####      ##  ##
##        ####    ##  ####    ##
########      ##    ##    ##  ##
##      ####    ##    ##      ##
##  ##      ##  ####  ##  ######
##  ######  ##    ##  ##      ##
##      ##    ##      ##  ##  ##
######  ####    ######  ##    ##
##          ##              ##  
################################
