################################
  ####  ##            ##      ##
####        ########  ##  ##  ##
##  ####  ##          ##  ######
##  ##  ##    ##  ####        ##
##      ##  ##  ##      ####  ##
##  ##  ##        ####  ##    ##
####      ######  ##      ##  ##
##    ##  ##  ##    ####  ##  ##
##  ##          ##  ##  ####  ##
##  ####  ####  ##  ##        ##
##      ##      ##      ####  ##
##  ##    ##  ##############  ##
##    ##    ##  ##      ##    ##
####    ##          ##      ##  
################################
