################################
  ##  ##      ####      ########
##        ####      ##    ######
##  ####  ##    ####  ##    ####
##      ##    ##        ##    ##
####  ####  ##    ##  ######  ##
####        ##  ##      ##    ##
##    ##  ##    ##  ##    ##  ##
##  ##    ####  ####    ##    ##
####    ##  ##      ######  ####
##    ##      ####  ##      ####
####      ##        ##  ####  ##
##  ############  ##    ##    ##
##        ##        ####    ####
##  ####      ####        ####  
################################
