################################
          ##  ##        ##    ##
##  ####        ##  ##    ##  ##
##      ##  ##  ##  ####      ##
####  ##    ##  ##      ####  ##
########  ##    ##  ##  ##    ##
####      ##  ##      ##    ####
##    ######  ##  ##    ##    ##
##  ##          ##  ####  ##  ##
##    ####  ##  ##            ##
####      ####    ##  ####  ####
##  ########  ##  ##  ##      ##
##  ##        ##  ##    ####  ##
##      ######      ##  ##    ##
##  ##          ##      ##  ##  
################################
