################################
    ##  ##    ##          ##  ##
##        ##      ##  ##  ##  ##
##  ####    ####  ##  ##      ##
##    ####      ####    ##  ####
####    ##  ##  ##    ##      ##
######    ####      ########  ##
####  ##      ####    ##  ##  ##
##    ##  ##  ##  ####    ######
##  ##    ##          ##      ##
##  ##  ##  ########    ####  ##
##  ##  ##  ##      ##        ##
##      ##      ##    ##  ######
####  ##    ####  ##  ####    ##
##        ##                ##  
################################
