################################
    ##                    ##  ##
##      ##  ##  ##  ####  ##  ##
############  ##    ##    ##  ##
##      ##        ##  ##      ##
##  ##      ######      ####  ##
##  ##  ####        ##    ##  ##
##    ##  ##  ##########  ##  ##
####  ##            ##  ##    ##
##    ##  ########          ####
##  ####          ##############
##      ########  ##        ####
##  ##  ##      ##    ####    ##
##  ##      ##    ##  ##  ##  ##
##    ##  ######            ##  
################################
