################################
  ##      ##  ##            ####
##    ##        ####  ####    ##
##  ##  ######        ######  ##
##  ##      ##########  ##    ##
##    ####              ##  ####
####      ##  ########  ##  ####
##  ####    ####        ##    ##
##      ####      ####    ##  ##
####  ####  ##  ########  ##  ##
##              ######    ##  ##
##  ##  ##  ##    ##    ####  ##
##  ##    ##  ####    ##      ##
##  ####  ##      ####  ##  ####
##    ##      ##                
################################
