################################
  ####          ##            ##
####    ######  ##  ##  ####  ##
##    ####  ##  ##  ####  ##  ##
####        ##  ##        ##  ##
##  ######    ##  ########    ##
##  ##    ##  ##            ####
##      ####  ####  ######    ##
##  ##  ##          ##      ####
##  ##    ########  ##  ####  ##
##  ####        ####    ####  ##
##      ##  ####      ##      ##
##  ##  ##  ####  ####  ##  ####
####    ##                    ##
##    ##    ##  ####  ##  ##    
################################
