################################
  ##        ##                ##
##    ####  ##  ##  ####  ##  ##
####    ##        ##    ##    ##
##    ##    ######    ##    ####
######    ##        ######    ##
##    ##      ####  ########  ##
####    ######        ######  ##
##  ##      ########    ##    ##
##    ####          ##  ##  ####
####      ####  ##    ##      ##
##    ##      ##    ####  ##  ##
##  ##  ####    ##        ##  ##
##  ##      ####  ########    ##
##      ##                  ##  
################################
