################################
  ##      ##  ##    ##        ##
##    ##          ##    ####  ##
##  ##  ########  ##  ##  ##  ##
##      ##        ##  ##      ##
####  ##    ######      ##  ####
####  ########  ##  ####      ##
##                ##      ##  ##
##  ############  ##  ##  ##  ##
####          ##    ##    ##  ##
##    ##  ##    ##    ##    ####
######      ##  ##  ##  ##    ##
##      ####  ##    ##      ####
##  ####          ##    ##    ##
##        ##  ##      ######    
################################
