################################
  ##  ##          ##        ####
##    ##  ######      ######  ##
##  ##    ##    ##  ##        ##
##  ##  ##  ##    ####  ####  ##
##      ##      ##      ####  ##
##  ####    ##      ####      ##
##  ##    ##  ##  ##      ##  ##
##    ####      ##    ######  ##
####  ##    ##  ####  ##      ##
####      ####    ##  ##  ######
##  ######    ##      ##      ##
##          ##  ##########  ####
##  ####  ##          ##      ##
##    ##      ##  ##      ##    
################################
