################################
            ##  ##            ##
##  ##  ##      ##  ####  ######
##    ##  ####        ##      ##
####      ##  ##  ##  ######  ##
##  ####        ######        ##
##      ######    ##    ##  ####
##  ####      ##  ##  ####    ##
##        ######  ##      ##  ##
##  ##  ####      ######  ##  ##
######  ##    ####    ##    ####
##      ##  ##    ##    ##    ##
##  ##  ##  ####      ######  ##
##  ####        ##  ##  ##    ##
##        ####      ##      ##  
################################
