################################
  ##              ##    ##    ##
##    ##  ######  ##  ##    ####
##  ####  ##              ##  ##
##  ##    ######  ##  ##  ##  ##
##  ##  ##      ##  ####  ##  ##
######  ##  ##  ##            ##
##      ##  ##    ##  ######  ##
##  ##  ##    ##    ####      ##
##  ##    ##    ##      ##  ####
##    ####    ##    ##  ##    ##
####  ##    ##    ##    ##  ####
##    ##  ##  ####    ####    ##
##  ####  ##    ##  ##      ####
##          ##      ##  ##      
################################
