################################
      ##  ##        ######    ##
##  ##      ##  ##    ##    ####
##      ##    ##  ##      ##  ##
##  ##  ####        ##  ##    ##
##  ##    ########      ##  ####
##  ##  ##      ######        ##
##    ####  ##        ######  ##
####          ####  ##        ##
##    ##  ##    ##    ##  ##  ##
##  ##  ##  ##  ####  ##    ####
##  ##  ##        ##    ##    ##
##  ##    ##  ##    ##    ##  ##
##    ##    ##  ####    ##    ##
####    ##            ##    ##  
################################
