################################
  ##        ##      ##  ##    ##
##    ##  ##    ####        ####
##  ##      ##        ####    ##
##  ##  ##    ##  ####    ##  ##
##  ##    ########      ####  ##
##    ##      ##    ##  ##    ##
####    ####      ####  ##  ####
##    ##    ########    ##  ####
##  ##  ##  ##        ##      ##
##          ##  ##  ##  ####  ##
######  ##  ##  ####          ##
##  ####    ##    ##  ##########
##        ##  ##  ##          ##
##  ##  ##            ##  ##    
################################
