################################
      ##              ######  ##
####      ####  ####    ##    ##
####  ####      ########    ####
##      ##  ##    ##      ##  ##
##  ##  ##  ######    ##  ##  ##
##  ##  ##      ##  ##    ##  ##
####      ####  ##    ##      ##
##    ####        ##    ##  ####
####  ##    ##  ##  ######    ##
##      ##  ##      ##    ##  ##
##  ##  ##  ######    ##      ##
####    ##        ####    ######
##    ####  ####    ##  ##    ##
##  ##          ##          ##  
################################
