################################
  ####  ##            ##      ##
####      ##  ##  ####    ##  ##
##    ##    ####        ##    ##
##  ######  ##    ##  ##    ####
##    ##    ##  ##      ##    ##
####  ##  ####    ####    ##  ##
####  ##  ##  ##      ##  ##  ##
##  ##    ##    ##  ##    ##  ##
##  ##  ##    ##    ##  ##    ##
##  ##    ##  ##  ##    ##  ####
##    ##  ##        ##  ##  ####
##  ####  ##  ######    ##    ##
##          ##      ##    ##  ##
##  ##  ##      ##      ##      
################################
