################################
  ##      ##  ##  ##          ##
##    ####            ######  ##
##  ##      ##  ##  ##        ##
##      ####  ##    ##  ####  ##
##  ####          ####      ####
##    ##  ##########  ####    ##
####  ##  ##            ####  ##
##  ##    ########  ####      ##
##      ##      ##    ##  ##  ##
##  ##  ##  ##    ##  ##    ####
##    ##      ##  ##    ##    ##
####    ######    ##  ##  ##  ##
##  ##  ##      ####      ##  ##
##          ####      ##        
################################
