################################
  ##  ##            ##        ##
##      ##  ##  ####    ##  ####
##  ####    ##  ####  ##    ####
##  ##    ##            ##    ##
##    ################    ##  ##
####      ##          ######  ##
##  ####      ######          ##
##    ########    ######  ##  ##
####          ##        ##    ##
##    ##  ####    ##  ####  ####
##  ##    ##    ##    ##    ####
##    ##    ##  ##  ####  ##  ##
####    ##  ##  ##            ##
######  ##        ##  ##  ##    
################################
