################################
      ##      ####      ##    ##
####      ####      ##    ##  ##
######  ####    ####  ##      ##
####    ##    ##        ##  ####
##    ########    ####        ##
##  ##  ##      ####  ##  ##  ##
##          ######      ####  ##
############        ####      ##
##            ######      ######
##  ##  ##  ##        ######  ##
##    ####      ######        ##
####      ########      ####  ##
##  ##  ##        ####  ##    ##
##          ####        ##  ##  
################################
