################################
        ####      ##          ##
##  ##        ##  ##  ##  ##  ##
##    ##  ####  ##      ####  ##
####  ####      ##  ####      ##
##      ##  ##      ##    ##  ##
##  ##        ##  ##  ##    ####
##    ##  ##  ####    ####  ####
##  ####  ##      ##    ##    ##
####    ##  ####  ####    ##  ##
##    ##      ##        ##    ##
####    ##  ####  ##  ##    ####
##    ##            ##    ######
####  ##############    ########
##                    ########  
################################
