################################
  ##              ##      ##  ##
##    ##  ####  ##    ##  ##  ##
####  ##    ##    ##  ##  ##  ##
##    ####    ##  ##  ##      ##
##  ##      ####    ##  ####  ##
##  ##  ####    ##      ##    ##
##  ##  ##  ##      ####    ####
##  ##        ####    ##  ##  ##
##    ##  ##  ##    ##    ##  ##
####    ##    ##  ##    ##    ##
####  ##    ##    ####  ##  ####
##    ##  ##    ##      ##    ##
##  ##    ########  ####    ####
##    ##                  ####  
################################
