################################
      ##    ##      ##        ##
####    ##  ##  ##      ####  ##
##  ##  ##  ##    ######      ##
##  ##  ##      ####  ##  ##  ##
##      ####  ##      ##    ####
##  ####          ##    ##    ##
##  ####  ##  ##    ##    ##  ##
##      ######  ####  ##  ##  ##
######    ##            ##    ##
##  ####      ########      ####
##    ##  ####        ####    ##
####    ##      ######    ##  ##
######    ####          ##    ##
########        ##  ##      ##  
################################
