################################
  ##  ##    ##    ##      ##  ##
##        ##    ##    ##      ##
##  ####  ##  ##    ##  ##  ####
##    ##        ##      ##    ##
####  ####  ##    ##  ##  ##  ##
##  ##  ####  ##    ##        ##
##            ####      ####  ##
##  ####  ##      ##  ##      ##
##    ##    ####    ##  ##  ####
####  ####  ##    ##          ##
##      ##    ####    ######  ##
####  ######        ##      ####
##      ##  ##########  ##    ##
##  ##                    ##    
################################
