################################
        ####          ##      ##
##  ##        ######  ##  ##  ##
##    ####  ##            ##  ##
##  ##      ####  ##  ##    ####
##    ##  ##      ####  ##    ##
####  ##    ##  ##  ##  ####  ##
##    ##  ##        ##    ######
####  ##    ##  ####  ##      ##
##    ####  ##          ####  ##
##  ##  ##  ######  ##  ##    ##
##      ##      ##    ##    ####
##  ##    ####  ######    ##  ##
##    ##    ##      ##  ##    ##
####    ##    ####          ##  
################################
