################################
          ##      ##          ##
##  ##  ##    ##  ##########  ##
##  ##  ##  ##            ##  ##
####    ##    ##  ##  ##  ##  ##
##    ##  ##    ##  ####      ##
####        ##  ##      ####  ##
##  ##  ####    ##  ##    ##  ##
##      ##    ##  ##    ##    ##
##  ####    ##        ####  ####
##      ##    ##  ##  ##    ####
##  ##  ######    ####    ##  ##
##  ##      ####        ##    ##
##  ####  ##      ######    ####
##    ##      ##          ####  
################################
