################################
  ##      ##      ##      ##  ##
##    ##    ##  ##    ##  ##  ##
##  ####  ##        ##    ##  ##
##  ##    ##  ######    ##    ##
##  ####      ##  ##  ######  ##
##      ##  ##    ##    ##    ##
##  ##  ####  ##    ##    ##  ##
##  ##          ##  ####  ##  ##
##    ####  ##  ##    ##      ##
####      ####    ##      ##  ##
##  ####      ##  ####  ####  ##
##    ####  ####      ##    ####
####    ##      ####  ##  ##  ##
######      ##    ##            
################################
