################################
  ######      ##    ##  ####  ##
######    ##    ##            ##
####    ######    ##  ##  ##  ##
##    ##  ##  ##    ##    ##  ##
##  ##          ####    ####  ##
##    ##  ####        ##      ##
####  ##      ####  ##    ##  ##
##    ##  ##    ####    ##    ##
##  ##      ##      ##    ##  ##
##  ##  ####    ##    ##    ####
##  ######    ##  ##    ##    ##
##        ####      ##    ##  ##
####  ##    ##  ##    ##  ##  ##
##      ##        ##      ##    
################################
