################################
  ####              ####  ##  ##
####    ######  ##            ##
##    ##      ##    ##  ####  ##
####  ##  ##    ####    ##  ####
##    ##    ####  ##  ##      ##
##  ##    ##              ##  ##
##    ##    ##  ##  ######    ##
####    ##  ##  ####    ##  ####
##  ##  ##  ##      ##  ##  ####
##    ##    ######      ##    ##
##  ##    ##        ##    ##  ##
##      ############    ##    ##
##  ####  ##        ####    ####
##            ####        ####  
################################
