################################
  ####      ######          ####
####    ##    ##    ##  ##    ##
##    ##  ##      ##    ########
##  ##      ##  ##    ##      ##
####    ##  ##  ####      ##  ##
####  ##    ##    ######  ##  ##
##    ####    ####      ##    ##
##  ##  ####        ##    ##  ##
##  ##    ######  ##  ####    ##
##    ##        ##        ##  ##
##  ##  ##  ##      ####      ##
##        ##########    ####  ##
####  ##    ##        ##      ##
##      ##      ####      ##    
################################
