################################
  ##          ##              ##
##    ######      ##  ##  ##  ##
##  ##    ####  ##      ##    ##
##    ##      ##    ##  ##  ####
####    ####    ####    ##  ####
##  ##      ##  ##    ####    ##
##    ####  ##  ####      ######
##  ##      ##      ####      ##
##    ##  ##  ####  ##    ##  ##
####          ##    ##  ##    ##
##    ##  ####    ##  ##    ####
##  ##  ##      ##        ######
##  ##  ##  ####  ##  ##    ####
##      ##              ##      
################################
