################################
  ##          ##  ##          ##
##    ##  ##      ##  ######  ##
##  ##      ##  ##    ##      ##
##    ##  ##    ##  ##    ##  ##
##  ##    ##  ####    ##    ####
####    ##        ##    ##    ##
##    ######  ##  ##  ##  ##  ##
##  ##  ##      ##        ##  ##
##        ########  ##  ##    ##
##  ####              ##    ####
##  ########  ########    ##  ##
##    ##    ##        ##      ##
####      ##    ####  ##  ##  ##
##    ##    ####          ##    
################################
