################################
          ##  ##        ##    ##
####  ##        ######      ####
##    ##  ####        ##  ##  ##
##  ##      ########  ##      ##
##    ##  ##      ##      ##  ##
####  ##  ##  ##    ##  ##    ##
##    ##  ##    ##  ##  ########
####  ##    ##  ##    ##      ##
##      ##  ##  ######    ##  ##
##  ##  ##  ##          ##    ##
##  ##  ################  ##  ##
##  ##      ##            ##  ##
##    ####  ##  ####  ####    ##
####    ##        ##        ##  
################################
