################################
  ##      ##              ##  ##
##    ##      ##########      ##
######    ####          ####  ##
##      ##  ##  ####  ##      ##
##  ####        ####    ##  ####
##      ##  ##      ##  ##    ##
##  ##  ##    ####    ##  ##  ##
####      ##  ##  ##          ##
##    ##    ##      ##  ####  ##
####  ##  ##    ##  ##  ##    ##
##      ##    ##      ##    ####
##  ##      ##  ####    ##  ####
####    ######      ####      ##
##    ##        ##        ##    
################################
