################################
  ##      ##    ##          ####
##    ##    ##    ##  ####    ##
##  ####  ######      ######  ##
##  ##      ##    ##    ####  ##
##    ####    ##    ##      ####
####      ##    ####  ####  ####
####  ##    ##          ##    ##
##      ##    ########  ####  ##
##  ####    ##      ##        ##
##    ##  ##    ##    ##  ##  ##
##  ####      ##    ##  ##    ##
##      ######  ##  ##    ##  ##
######      ##  ##    ##  ##  ##
##      ##        ##      ##    
################################
