################################
  ##    ##    ##      ######  ##
##    ##    ##    ##    ##    ##
##  ##    ##  ##    ##      ####
##      ##    ##  ##  ##  ##  ##
####  ##  ##      ##  ##      ##
####          ####      ####  ##
##    ##  ##      ####    ##  ##
##  ##  ##  ####  ##    ####  ##
####    ##  ##        ####    ##
##    ####      ##  ####    ####
##  ##      ##  ####      ######
##  ##  ####  ##      ##  ######
##    ##          ####      ####
####      ####  ##      ##      
################################
