################################
    ##        ######        ####
##      ####    ##    ####    ##
####  ##    ##  ##  ##    ##  ##
####    ##      ####  ##      ##
##    ##    ####      ##  ######
##  ##  ####  ##  ##      ##  ##
##  ##        ##    ######    ##
##  ##  ####      ##        ####
##  ##      ##  ##    ####    ##
##  ######    ##  ####      ####
##        ##          ####    ##
##  ##  ##  ####  ##      ##  ##
##  ##  ##      ####  ####    ##
##  ##      ##              ##  
################################
