################################
        ##      ##      ##    ##
##  ##      ##  ##  ##    ##  ##
##  ##  ##    ##    ##  ##    ##
##  ######  ####  ##    ##  ####
##        ##      ####  ##    ##
##  ####      ####      ####  ##
##      ######  ##  ####      ##
####  ##            ##  ##  ####
####    ##  ######  ##        ##
##    ##  ##      ##    ####  ##
##  ##        ##    ####      ##
##    ####  ##    ##      ##  ##
####        ##  ####  ####    ##
##    ##  ##          ##    ##  
################################
