################################
                ##        ######
##  ######  ##      ####    ####
##  ##        ##  ##    ##    ##
####    ####  ##    ##      ####
##  ##      ##    ######  ##  ##
##  ##  ##    ##    ##    ##  ##
##  ########  ##  ##    ####  ##
##      ####    ##    ##      ##
##  ##      ##    ##    ##  ####
####  ####    ##    ##      ####
##      ##  ##    ##  ####    ##
##  ##  ##  ##  ##    ######  ##
##    ####  ##    ##    ##    ##
####            ######      ##  
################################
