################################
  ##                    ##    ##
##    ##########  ####      ####
##  ##        ##    ######    ##
##    ####  ##  ##        ######
####    ##      ########      ##
##  ##    ##  ##        ####  ##
##  ##  ##    ##  ####    ##  ##
##      ##  ####      ##      ##
##  ####        ##  ##  ####  ##
##      ##  ##  ##          ####
######      ##    ########  ####
##    ######    ##      ##    ##
####      ##  ####  ##  ########
##    ##            ##          
################################
