################################
      ##              ######  ##
####      ##  ######    ##    ##
##  ##  ##  ##      ##      ####
##      ##  ##  ##    ####    ##
##  ##  ##      ####  ##  ##  ##
####    ##  ####  ##      ##  ##
##    ##      ##  ##  ####    ##
####    ####      ##        ####
######      ##  ##  ############
####    ##  ##      ##      ####
##    ####    ####    ####    ##
####      ##  ##  ##      ##  ##
##  ##  ####        ##  ##    ##
##          ##  ####        ##  
################################
