################################
  ##  ##            ##        ##
##    ##  ##  ##  ##    ####  ##
##  ##    ##  ##      ####    ##
##      ##  ##    ####      ####
##  ####    ##  ##  ########  ##
##  ##  ##  ##                ##
##  ##        ##############  ##
##    ##  ##  ##          ##  ##
####      ##    ##  ####      ##
##  ##  ##  ##    ##    ##  ####
##    ##      ##    ##    ##  ##
####      ##  ##  ##  ##      ##
##    ##  ##  ##  ##  ##  ##  ##
##  ##    ##              ##    
################################
