################################
    ##      ##        ##      ##
##      ##      ##  ##    ##  ##
##  ############      ####    ##
##      ##    ##  ##        ####
##  ####    ##      ##  ##  ####
##        ##    ##  ######    ##
####  ##  ####    ##      ##  ##
##  ##        ##      ##    ####
##    ####  ##  ##  ##  ##    ##
####    ##      ##      ##  ####
##  ##  ######    ##  ##      ##
##  ##      ####    ##    ##  ##
##  ##  ##    ######    ##    ##
##        ##          ##    ##  
################################
