################################
          ##        ##  ##    ##
####  ##      ####  ##      ####
##      ######  ##  ##  ##    ##
######  ##      ##      ##  ####
##      ##  ##    ##  ##      ##
##  ####    ##  ##  ####  ##  ##
##  ######    ##            ####
##    ##  ##      ########    ##
####        ######        ######
##  ##  ####        ####      ##
##        ##  ##  ####    ##  ##
##  ####  ##  ##  ##    ##    ##
##  ####        ##  ####    ####
##      ##  ##  ##        ####  
################################
