################################
  ##        ##                ##
##    ####  ##  ##  ##  ####  ##
##  ##      ##  ##    ##  ##  ##
##    ##  ##      ##      ##  ##
##  ########  ##    ####  ##  ##
##    ##        ##    ######  ##
##  ##    ##  ##  ####        ##
##  ##  ######          ####  ##
##  ##    ##    ####  ##  ##  ##
##  ##  ##    ##    ##        ##
##  ##  ##  ##    ##    ########
##  ##  ##    ##    ##  ##    ##
##  ######  ##  ##  ##      ####
##          ##          ##      
################################
