################################
  ####            ####        ##
####    ########        ##  ####
##    ####      ######    ##  ##
##  ##      ##        ##  ##  ##
##  ##  ##    ######    ####  ##
##    ##  ##        ##        ##
####        ####  ##  ##########
##    ####    ##      ##      ##
##  ##      ########  ##  ##  ##
##    ##  ##  ##      ####    ##
##  ##    ##  ##  ####      ####
##    ##      ##  ##    ##    ##
####  ######  ##  ######  ##  ##
##        ##                    
################################
