################################
  ##        ##        ##  ##  ##
##    ####    ##  ##  ##      ##
##  ##      ##    ##      ##  ##
##  ######    ##  ##  ##    ####
##        ##      ##    ##    ##
########    ##  ####  ######  ##
##      ##    ##        ##    ##
##  ####  ####    ##  ##    ####
##            ##    ##    ##  ##
####  ######    ####    ##    ##
##    ##      ##      ##  ##  ##
##  ##    ######  ####    ##  ##
##  ######          ##  ##    ##
##          ##  ##          ##  
################################
