################################
        ##        ##  ##      ##
##  ##  ####  ##          ##  ##
##  ##          ##  ####    ####
##    ##  ######  ##    ##    ##
##  ##  ##            ##    ####
##  ##      ##  ######  ##    ##
##  ####  ##    ##        ##  ##
##      ######      ####  ##  ##
##  ##    ######  ##  ##  ##  ##
##    ##    ##    ##  ##      ##
####    ##  ##  ##      ##  ####
##    ##    ##  ##  ##    ##  ##
######    ##      ####  ##    ##
##      ##    ##            ##  
################################
