################################
                ####          ##
##  ######  ##      ########  ##
##  ##      ######  ##        ##
####    ####        ##  ##  ####
##    ##  ##  ####      ##    ##
##  ##      ####  ##  ##    ####
##  ##  ##          ##    ##  ##
##  ##  ######  ##  ##  ##    ##
##  ##      ##    ####      ####
##    ##  ##  ##      ####  ####
##  ##          ####  ##      ##
##  ######  ####  ##      ##  ##
##      ####        ##  ##    ##
##  ##        ####    ##    ##  
################################
