################################
            ##  ##          ####
##  ##  ####    ##  ######    ##
##  ##        ##          ##  ##
##    ####  ##  ######  ##    ##
####      ##              ##  ##
##    ##  ##  ####  ######    ##
####  ##  ##      ##        ####
##      ##  ####  ##  ####    ##
##  ##            ##  ##  ######
##  ##  ########  ##          ##
##    ####      ##  ##  ####  ##
##  ##      ####      ####    ##
##  ##  ####      ##  ##    ####
##  ##        ####        ####  
################################
