################################
        ##                    ##
##  ######  ##  ######  ####  ##
##  ##        ##      ##      ##
##      ##  ##    ##  ##  ##  ##
##  ##########  ####      ##  ##
##      ##      ##  ########  ##
##  ##  ##  ####              ##
##    ##      ######  ##  ##  ##
####  ##  ####      ##  ##  ####
####  ##  ##    ##            ##
##    ##      ##    ##  ####  ##
##  ##  ##  ##  ####      ##  ##
##  ##  ####        ######    ##
##  ##        ####          ##  
################################
