################################
  ##  ##    ##            ##  ##
##        ##    ##  ####  ##  ##
##  ####  ##  ##    ####      ##
##      ##    ##  ##    ##  ####
####  ##    ####    ##        ##
##    ####      ##    ##  ##  ##
####        ########  ##  ##  ##
##    ######    ##    ####    ##
####  ##      ##  ##      ##  ##
##    ##  ####        ##  ######
##  ##    ##  ######  ##      ##
##  ##  ##          ########  ##
##  ##    ####  ##    ##      ##
##    ##          ##      ##    
################################
