################################
    ##          ##        ##  ##
##      ##  ##  ##  ####  ##  ##
##  ####    ##  ##  ##        ##
##  ##  ##  ##  ##  ##  ########
##      ##  ##  ##    ##      ##
####  ##    ##  ##  ##    ##  ##
##  ##    ##    ##  ##  ##    ##
##      ##    ##    ##  ####  ##
######  ##  ##    ##      ##  ##
##      ##  ####  ##  ####    ##
##  ####      ##  ##  ##    ####
##  ##  ####      ##  ##  ##  ##
##          ######      ##    ##
##  ##  ##          ##      ##  
################################
