################################
    ##        ##  ####        ##
##    ######            ##  ####
####      ##  ############    ##
##    ####  ##            ##  ##
##  ##  ##      ########  ##  ##
##  ##      ####      ##      ##
##  ##  ####  ##  ##########  ##
##  ##    ##          ##      ##
##  ####  ##  ##  ##    ##  ####
##    ##    ##  ######        ##
####    ##        ####  ####  ##
######  ########      ####    ##
####            ####  ##    ####
##    ####  ##        ##  ####  
################################
