################################
  ##  ##      ##          ##  ##
##      ##  ####  ######  ##  ##
##  ##      ##    ##  ##  ##  ##
##  ####  ##    ##    ##      ##
##    ####    ##    ##  ####  ##
####    ##  ##  ##      ##    ##
##  ##    ##        ##  ##  ####
##    ##    ##  ######      ####
####      ##    ##    ######  ##
##    ######  ####  ##    ##  ##
##  ##        ##      ##      ##
##      ######    ##    ##  ####
####  ####  ##  ##  ##        ##
##                    ##  ##    
################################
