################################
              ####      ##    ##
##  ##########      ##  ##  ####
##  ##          ####    ##    ##
##  ##  ####  ##  ##  ##  ##  ##
##  ##      ##    ######  ##  ##
##  ######    ##              ##
##      ##  ##    ####  ##  ####
####  ##    ####    ##  ##    ##
##    ##  ##    ##  ##  ####  ##
####      ####      ##    ##  ##
##    ####  ##  ##  ####  ##  ##
##  ##        ##      ##    ####
##    ##  ##  ########  ##    ##
####      ##                ##  
################################
