################################
  ##      ##        ####      ##
##    ##    ##  ##      ####  ##
##  ######        ####        ##
##    ##  ######    ########  ##
####      ##    ##          ####
##  ####    ##    ########  ####
##  ##    ##  ##        ##    ##
##      ##        ######  ##  ##
####  ##    ####  ##      ##  ##
##    ##  ##  ##  ##  ##  ##  ##
##  ##    ##      ##    ##    ##
##      ##    ##  ####    ##  ##
########    ####      ##      ##
##        ##      ##    ####    
################################
