################################
        ##      ##            ##
##  ##    ####    ######  ##  ##
##  ##  ####  ##          ##  ##
##  ##          ##########    ##
##  ####  ####          ##  ####
##    ##      ##  ##  ##    ####
##  ##    ####      ##    ##  ##
####    ##      ##  ##  ##    ##
##    ##  ##  ##  ##    ##  ####
##  ##        ##      ##      ##
##    ####  ##  ##  ######  ####
####  ##        ##  ######    ##
##    ##########      ##    ####
####              ##      ####  
################################
