################################
              ##        ##    ##
##  ##  ####      ####  ##  ####
##    ##    ##########  ##    ##
####    ##        ##      ##  ##
##  ##    ####  ##    ####    ##
##  ####  ##    ##  ##      ####
##      ####  ##    ##  ########
##  ##  ##    ####  ##      ####
##  ##      ##      ##  ##    ##
####    ######  ##  ##    ##  ##
##    ##        ####    ##    ##
##  ####  ##  ##      ##    ####
##  ##      ##  ######    ######
##      ##              ######  
################################
