################################
        ##          ##        ##
##  ##      ##  ##      ##  ####
##    ######    ##  ##  ##  ####
##  ##      ##    ##    ##    ##
##  ##  ##    ####    ##  ##  ##
##  ##    ##      ####        ##
####    ##  ####    ##  ####  ##
####  ##        ##  ##  ##    ##
##    ##  ####      ##  ##  ####
##  ####      ##  ##    ##  ####
##  ##  ####  ##  ##  ##      ##
##        ##    ##    ##  ##  ##
####  ##    ####    ##  ##    ##
##      ##        ##        ##  
################################
