################################
  ##            ##  ##      ####
##    ##  ##  ##        ##    ##
##  ##      ##    ######    ####
##    ##  ##    ####      ##  ##
########    ##      ##  ##    ##
##        ########  ##  ####  ##
##  ####    ##  ##  ##        ##
##      ####    ##    ######  ##
######    ##  ####  ##        ##
##      ####        ##  ##  ####
##  ##      ##  ####    ####  ##
##  ########  ##      ##      ##
##              ##  ####  ##  ##
##  ##  ##  ##            ##    
################################
