################################
  ##  ##      ####            ##
##        ##      ##  ##  ##  ##
##  ##  ##  ####    ######    ##
##    ##      ####    ####  ####
####  ##  ##      ##          ##
##    ##    ##  ##  ##  ####  ##
####    ##  ##        ##      ##
##    ####    ##  ####    ######
######    ##  ##      ##  ##  ##
##    ##        ####  ##  ##  ##
####      ####  ##    ##  ##  ##
##    ######  ##    ##        ##
##  ####      ##  ##    ####  ##
##        ##  ##      ##        
################################
