################################
            ##                ##
##  ##  ##      ##  ######  ####
####      ##########          ##
##    ####      ##    ##########
##  ##  ##  ##  ##  ####      ##
##          ##    ##      ##  ##
##  ############      ####    ##
##          ##  ######  ##  ####
##  ######          ##  ##    ##
####      ##  ##  ##    ####  ##
##    ##    ####  ##  ##      ##
##  ##  ##        ##      ######
##  ##    ##  ####  ######    ##
##      ##                  ##  
################################
