################################
  ##          ####    ##      ##
##    ##  ##      ##    ##  ####
##  ##  ##  ##  ######  ##    ##
##  ##      ##    ####    ##  ##
##      ####    ##      ##    ##
##  ##  ##    ####  ####    ####
##  ##    ##        ######    ##
####    ##  ####  ##  ######  ##
##    ##        ##      ##    ##
####  ##  ####    ####      ####
##    ##      ##      ##  ##  ##
##  ##    ##  ##  ####        ##
##  ##  ##  ##        ######  ##
##      ##      ####            
################################
