################################
  ####      ####              ##
####    ####      ##########  ##
##    ##  ##  ####        ##  ##
##  ##        ####  ####  ##  ##
##      ##  ##        ##  ##  ##
##  ##    ##    ######    ##  ##
##    ####    ####    ######  ##
####    ##  ##      ##        ##
##  ##  ##  ####  ##    ####  ##
##  ##  ##    ##      ##      ##
##  ##    ##      ########  ####
##  ##  ##  ##  ##    ##      ##
##  ##      ####  ##    ####  ##
##      ##          ##          
################################
