################################
  ##        ##        ##      ##
##    ####  ####  ####    ##  ##
##  ####      ##        ##    ##
##      ####  ##  ##  ##  ##  ##
######    ##    ##    ##  ##  ##
##  ####    ##    ####        ##
##    ######  ##  ##    ########
####          ##  ##  ##      ##
##    ####  ##    ##      ##  ##
####    ##    ##  ######  ##  ##
##  ##    ##  ##        ##    ##
##      ##      ######    ##  ##
####  ##  ##  ##      ##  ##  ##
##        ##      ##            
################################
