################################
        ######        ##      ##
##  ##    ##    ####  ######  ##
##    ##      ##  ##      ##  ##
##  ##  ##  ####    ####  ##  ##
##  ##    ##      ##      ##  ##
##    ##      ##  ##  ######  ##
####    ##  ##  ##    ##      ##
######      ##      ##    ######
####    ##  ##  ####  ##      ##
##    ##  ##    ##      ####  ##
##  ##      ####  ##  ##      ##
##    ####                ##  ##
####  ##  ##########  ####    ##
##                    ##    ##  
################################
