################################
  ##          ##      ##  ##  ##
##    ######      ##          ##
##  ##      ######    ######  ##
##  ##  ##  ##      ##      ####
####    ##      ####    ##    ##
##    ##  ##  ##      ##    ####
##  ##      ##    ##  ##  ######
##  ##  ##  ##  ##  ##    ######
##        ####  ##    ##    ####
##  ####        ####    ##    ##
##  ##  ####  ##      ######  ##
##  ##      ##    ####  ##    ##
##  ##  ##      ##        ##  ##
##      ##  ##    ##  ##        
################################
