################################
  ##            ##        ##  ##
##    ##########    ####  ##  ##
##  ##            ##  ##  ##  ##
##      ############      ##  ##
##  ######          ##  ##    ##
##  ##      ##  ##    ##    ####
##    ##  ##      ##    ##    ##
####  ######  ####  ##      ####
####        ####      ##  ##  ##
##  ######  ##    ##          ##
##          ##  ##  ####  ##  ##
####  ######    ##      ##    ##
##        ##  ####  ##    ##  ##
##  ####      ##      ##        
################################
