################################
        ##      ##            ##
##  ##    ####      ####  ##  ##
##    ##  ##    ####      ##  ##
##  ####  ##  ##    ##  ##    ##
##  ##    ##    ##  ##    ##  ##
##    ##  ####        ##  ##  ##
####  ##    ####  ##  ##    ####
##      ##      ##      ##  ####
##  ##    ####  ######  ##    ##
##  ##  ##          ##    ##  ##
##  ####    ######  ##  ##    ##
##      ##  ##        ##    ####
##  ##    ##  ##  ####    ######
##    ##      ##        ######  
################################
