################################
  ##      ##        ##        ##
##    ##  ##  ####  ##  ##  ####
########  ##    ##  ##  ##  ####
##        ##  ##    ##  ##    ##
##  ########    ##      ####  ##
##          ##    ######      ##
##########  ##  ##    ##  ##  ##
##      ##  ##      ##    ##  ##
##  ##  ##      ####    ####  ##
##  ##    ##  ##      ##    ####
##    ##    ####  ##    ##    ##
####  ####        ##  ##  ##  ##
####      ########  ##        ##
##    ##                ##  ##  
################################
