################################
    ##          ##  ##        ##
##      ######      ##  ####  ##
####  ##      ##  ####  ##    ##
##    ##  ##  ##        ##  ####
##  ####    ##    ######      ##
####      ####  ##    ##  ######
##    ####        ##  ##      ##
##  ##      ####      ######  ##
##  ##  ##      ##  ##        ##
##    ##    ##    ##    ####  ##
####    ##    ####    ######  ##
##  ##    ####      ######    ##
##    ##  ##    ####  ##    ####
####          ##          ####  
################################
