################################
  ######        ####        ####
######    ####        ####    ##
####    ##    ##  ##    ########
##    ##  ##      ##  ##      ##
##  ##      ####    ##    ##  ##
######  ##  ######      ####  ##
##      ##    ##  ##  ##      ##
##  ####  ##      ##  ##  ##  ##
##    ##    ##  ##    ##    ####
####      ##  ##    ##  ##    ##
##  ####  ##      ##      ##  ##
##    ##  ####  ##    ##  ##  ##
##  ##        ##    ####      ##
##      ####      ##      ##    
################################
