################################
  ####  ##              ##    ##
####    ##  ######  ##    ##  ##
##    ####      ##  ####      ##
##  ####  ####  ##    ##  ##  ##
##        ##    ####  ######  ##
####  ####    ##  ##        ####
####    ##  ##    ########  ####
##    ####    ##        ##    ##
##  ####  ##  ##  ####    ##  ##
##        ##  ##    ####  ##  ##
####  ####    ######      ##  ##
####        ##        ##  ##  ##
##    ##  ##  ##  ####  ##    ##
##  ##            ##        ##  
################################
