################################
  ##      ##  ##      ##    ####
##    ##  ##      ##    ##    ##
##  ####    ##  ##    ##  ##  ##
##      ##      ##  ##        ##
######    ##  ##    ##  ##  ####
##  ####    ####  ########    ##
##      ##  ##      ##      ####
##  ##  ##    ####  ##  ##    ##
##  ##    ####  ##      ####  ##
##    ##        ####  ##  ##  ##
##  ##  ######      ##        ##
##  ##        ####      ##  ####
##  ####  ##    ########  ##  ##
##          ##                  
################################
