################################
  ####      ##            ##  ##
####    ##      ##  ##  ##    ##
##    ##  ####  ######      ####
##  ##        ##        ##    ##
##  ##  ####  ##  ##########  ##
##  ##    ##  ##  ##    ##    ##
##  ##  ##    ##    ##      ####
##    ####  ##    ####  ####  ##
####  ##    ##  ####      ##  ##
##        ##    ##    ##  ##  ##
##  ##  ####  ##  ####    ##  ##
##    ##      ##        ##    ##
##  ####  ####    ##  ##    ####
##      ##      ##        ####  
################################
