################################
    ##  ##    ##  ##          ##
##          ##      ##  ########
####  ####  ##  ##            ##
##        ##    ############  ##
####  ######  ##          ##  ##
####          ##  ######    ####
##    ########          ##    ##
##  ##        ########  ####  ##
##  ##  ####          ##      ##
##  ######    ######  ##  ######
##          ##    ##  ##      ##
############  ##      ##  ##  ##
##            ##  ####  ##    ##
##  ##  ####                ##  
################################
