################################
    ##        ##    ##        ##
##      ####      ##    ##  ####
##  ##      ####  ####  ##    ##
##    ####    ##      ##  ##  ##
##  ##  ##  ##  ####  ##  ##  ##
##      ##  ##    ##          ##
####  ##    ##  ##  ######  ####
######    ##        ##  ##    ##
####    ##    ####        ##  ##
##    ##    ##    ##  ####    ##
##  ##  ##      ######      ####
##  ##      ##    ##    ####  ##
####  ####  ####  ##  ####    ##
##            ##            ##  
################################
