################################
  ##      ##      ##        ####
##  ####      ##  ##  ####    ##
##      ######    ##      ##  ##
##  ##          ##  ##  ####  ##
##    ##########        ##    ##
##  ##        ##  ####    ##  ##
##  ##  ####  ##  ##  ##    ####
##  ##      ####  ##    ##    ##
##  ##  ##            ##    ####
##  ##    ##  ########    ##  ##
##    ##  ######      ##  ##  ##
####  ####        ##  ##      ##
##          ######      ####  ##
##  ####  ##        ##          
################################
