################################
  ##          ##  ##  ##      ##
##    ######            ####  ##
##  ##      ######  ##  ##    ##
######  ##  ##      ##  ##  ####
##      ##  ##  ####        ####
##  ####    ##      ######    ##
##  ##    ##  ####      ####  ##
##    ####        ####    ######
##  ##      ####      ##      ##
##    ##  ##    ##  ##    ##  ##
####  ##    ##  ##  ##  ####  ##
##      ##  ##  ##    ##      ##
##  ##      ##  ##  ####  ##  ##
##    ##  ##              ##    
################################
