################################
    ##  ##              ####  ##
##          ##  ##  ##        ##
##  ##  ####  ##      ##  ##  ##
##    ####      ##  ####  ##  ##
######      ##    ##      ##  ##
##      ####    ##    ####    ##
##  ####      ##    ##    ##  ##
##  ##    ####    ##  ##      ##
####    ########  ##  ##  ######
##  ##    ####    ##      ##  ##
##  ####        ####  ####    ##
##    ######  ####    ######  ##
####        ##      ##  ##    ##
##    ####      ##          ##  
################################
