################################
      ####        ##        ####
####        ####      ####    ##
##    ######    ##  ##    ##  ##
##  ##        ##  ##    ##    ##
##  ####  ##  ##  ##  ##    ####
##      ####      ##      ##  ##
######      ##  ##########    ##
##    ####        ##        ####
##  ##    ######    ####  ##  ##
##      ##      ##    ##      ##
##  ####    ##  ####      ##  ##
##        ####      ##  ##    ##
##  ######    ####    ##    ####
##          ########      ####  
################################
