################################
              ##        ########
##  ##  ####      ####    ######
##  ##    ##  ####    ##    ####
######  ##        ##    ##    ##
##      ##  ##  ######    ######
##  ####  ##      ######      ##
##          ####    ##  ####  ##
##  ##  ##      ##  ##    ##  ##
##    ##  ##  ##      ##  ##  ##
####  ##  ##  ##  ##      ##  ##
##    ##  ##    ######  ##    ##
####        ##    ######    ####
##  ####  ##  ##    ##    ######
##              ##      ######  
################################
