################################
      ##                    ####
####      ##  ########  ##    ##
##    ##    ##        ######  ##
##  ##  ##    ##  ##  ####    ##
####      ####    ##        ####
##    ##    ##  ##  ######    ##
##  ######      ##          ####
##    ##    ######  ##  ####  ##
####    ####      ##    ##    ##
##  ##  ##    ##    ####    ####
##      ##  ##  ##    ##  ##  ##
##  ##  ##  ##    ##      ##  ##
##  ##  ##      ##  ######    ##
##  ##      ##              ##  
################################
