################################
  ##            ######        ##
##    ##  ####    ##    ##  ####
##  ##    ##  ##    ##  ##    ##
####    ##    ##  ##    ##  ####
##    ##  ##        ##  ##    ##
##  ##    ####  ##  ##    ##  ##
##    ##      ##      ####    ##
####    ####  ##  ##      ##  ##
##    ##  ##    ##  ####      ##
##  ##      ##  ##  ##  ####  ##
##      ##  ##  ##        ##  ##
##  ####    ##    ##  ######  ##
##    ######    ####          ##
####          ##      ##  ##    
################################
