################################
  ##    ##      ##          ####
##    ##    ##    ##  ####    ##
##  ######    ##  ##  ##  ######
##    ##  ##  ##      ##  ##  ##
####          ########        ##
##    ####  ##        ######  ##
##  ##    ##  ######          ##
##  ####            ####  ##  ##
##      ####  ####  ##    ##  ##
####  ##      ##      ##    ####
####      ####  ####    ##    ##
##  ######  ##      ##  ##  ####
##          ##  ##  ##  ##    ##
##  ##  ##      ##          ##  
################################
