################################
        ######          ##    ##
##  ##    ##    ######  ##  ####
##    ##      ##    ##  ##    ##
####    ######    ##    ##  ####
##    ##        ####  ##      ##
####    ##  ##  ##      ##  ####
##    ##    ##    ####  ##    ##
##  ##    ##  ##      ##    ####
##  ####        ####      ##  ##
##    ##  ####      ####  ##  ##
####  ##  ##    ##  ##        ##
##    ##    ######    ##  ##  ##
##  ##  ####      ##    ##    ##
##            ##      ##    ##  
################################
