################################
  ######        ####      ##  ##
######    ##  ##      ##      ##
####    ##    ##  ####  ##  ####
##  ####    ##    ##    ##    ##
##    ##  ##    ##  ##  ##  ####
####  ##    ##  ##  ##  ##    ##
##    ####              ##  ####
####      ##  ############    ##
##  ####    ##              ####
##  ##    ##    ####  ####    ##
##  ##  ##  ##      ##    ##  ##
##      ##  ##  ##  ##  ##    ##
####  ##      ####  ##  ####  ##
##        ##        ##          
################################
