################################
            ##  ##      ##    ##
##########          ##      ####
##      ##  ##  ####    ##    ##
##  ##    ##    ####  ##  ##  ##
##    ##      ##      ##    ####
####    ######    ####  ##    ##
##  ####        ##      ####  ##
##  ##    ##########  ##      ##
##  ##  ##      ##        ##  ##
##      ##  ##      ##  ##    ##
####  ##  ##    ######    ##  ##
##    ##      ##      ##  ##  ##
####  ########    ##    ##    ##
##              ######      ##  
################################
