################################
      ##  ####            ##  ##
##  ##        ######  ##      ##
##      ####      ##    ##  ####
##  ####    ####    ##  ##    ##
##  ##  ##    ######    ##  ####
##  ##    ##          ####    ##
##    ##      ######  ##  ##  ##
####  ####  ####      ##  ##  ##
####      ##      ####    ##  ##
##  ####    ##  ##    ##      ##
##  ######  ##  ##  ####  ######
##    ##    ##  ##  ##    ##  ##
####  ##  ##    ##  ##  ##    ##
##            ##            ##  
################################
