################################
      ##          ##        ####
##  ##    ##  ##  ##  ####    ##
##      ##  ##        ##  ##  ##
##  ####        ######        ##
##      ####  ##      ##  ######
##  ##      ##    ##  ##  ##  ##
##  ######    ####    ##      ##
####        ##      ##  ####  ##
##    ######    ##  ##  ##    ##
####  ##    ##  ##      ##  ####
##  ##  ##        ######    ####
##  ##      ##  ##        ##  ##
##    ####  ##  ##  ######    ##
####        ##              ##  
################################
