################################
  ##  ##            ##      ####
##    ####  ######    ####    ##
####    ##  ##    ##      ##  ##
##  ##      ##  ##  ####      ##
##    ##  ##            ####  ##
##  ##  ############  ####    ##
##        ##          ##    ####
##  ####      ####  ##    ##  ##
##  ##  ##  ##      ##  ####  ##
##      ##    ####  ##        ##
####  ##  ##  ##      ##  ##  ##
##    ##  ##    ##  ##  ##    ##
####  ##    ##    ##      ##  ##
##        ######      ##        
################################
