################################
  ##    ##      ##        ##  ##
##    ##    ##    ##  ##      ##
##  ####  ##  ####      ####  ##
##  ##    ##        ##    ##  ##
##    ##  ##  ######    ##    ##
####  ##    ##      ##  ##  ####
##    ##  ##    ##    ##      ##
##  ####    ##    ##    ####  ##
##      ##    ##  ####        ##
####  ##  ##  ##      ####  ####
####      ##  ##  ##    ##    ##
##    ##  ##  ####    ##  ##  ##
##  ####            ##    ##  ##
##      ##  ##  ##    ##        
################################
