################################
  ##    ##                ##  ##
##    ##    ##  ########      ##
##  ####  ##    ##      ####  ##
##          ##  ##  ##        ##
##  ####  ##    ##    ####  ####
##      ##    ####  ##    ##  ##
####  ##    ##      ####      ##
##  ##    ##  ####    ##  ##  ##
##      ##    ##  ##    ####  ##
##  ##    ##  ##      ##      ##
##    ####    ##  ####    ##  ##
####    ##  ####        ####  ##
##  ##      ##  ##########    ##
##      ####                ##  
################################
