################################
  ##            ##      ####  ##
##    ##  ##  ##    ##        ##
##  ##    ##    ##    ####  ####
####    ##  ##    ##    ##    ##
##    ##      ##    ####  ##  ##
##  ##    ####  ##        ##  ##
##    ##          ####  ##    ##
##  ##  ##  ######      ##  ####
##  ##      ##      ####    ####
##    ####      ##  ##    ##  ##
####  ####  ##    ##    ####  ##
##        ##  ##      ##      ##
##  ####  ##  ########    ##  ##
##    ##                ##      
################################
