################################
  ####                ##      ##
####    ########  ####    ##  ##
##    ##          ##    ##    ##
##  ####  ######    ####    ####
##  ##    ##    ##  ##    ######
##  ##  ##  ##          ########
##  ##  ##      ######    ######
##  ##  ####  ##      ##    ####
##  ##      ####  ##  ####    ##
##  ######  ##    ##      ##  ##
##      ##    ##    ####      ##
########    ##    ##    ########
##    ##  ####  ####  ##      ##
####      ##              ##    
################################
