################################
    ##      ##                ##
##      ######  ##  ##  ##  ####
##  ##  ##        ##      ##  ##
##    ##    ####    ##  ##    ##
####  ##  ##    ####    ##  ####
##            ##      ##      ##
####  ##  ####    ##    ####  ##
##      ##      ######    ##  ##
########    ####  ##    ####  ##
##        ##          ##      ##
##  ####  ######  ####    ######
##      ##      ##      ##    ##
####  ####  ##    ##  ##    ####
##            ##          ####  
################################
