################################
    ##    ##        ##    ##  ##
##    ##      ####    ##      ##
####      ####  ####    ##  ####
##    ##    ##    ####  ##  ####
##  ##  ##    ##        ##    ##
##        ##    ##  ##    ##  ##
##  ######  ##    ##    ##    ##
####        ##  ##    ##  ##  ##
##    ####      ##  ##        ##
####  ##    ######      ####  ##
##    ##  ##      ##########  ##
####    ##    ##        ##    ##
######  ####  ######  ##    ####
########          ##      ####  
################################
