################################
  ##        ##                ##
##    ####    ##  ##  ##  ##  ##
##  ##    ##  ##    ##    ##  ##
##      ####    ##  ##  ####  ##
######  ##  ##  ##  ##      ####
##  ##        ##      ####    ##
##      ##  ##    ######  ##  ##
##  ####  ##    ####      ##  ##
##    ##      ####    ##      ##
####  ##  ####      ##  ####  ##
####    ##      ######    ##  ##
##  ##  ##  ##  ##      ####  ##
##  ##  ######  ##  ######    ##
##              ##          ##  
################################
