################################
  ##              ##          ##
##    ##  ######    ####  ######
##  ####        ##    ##      ##
##  ##    ####    ##    ####  ##
####  ####  ##  ####  ##      ##
##    ##        ##    ##  ##  ##
####  ##  ##  ##    ##      ####
##    ##  ##  ##  ##    ##  ####
####      ####    ##  ##      ##
##  ######      ##      ####  ##
##  ##  ##  ####    ####      ##
##      ##  ##  ##  ##    ##  ##
####  ##          ##    ####  ##
##        ##  ##      ##        
################################
