################################
        ##      ##  ##        ##
####  ##    ##  ##      ####  ##
####    ##  ##  ##  ####      ##
##    ####  ##  ##    ##  ##  ##
##  ##      ##    ##  ##  ##  ##
##  ##  ########    ##    ##  ##
##    ##    ##  ##  ####    ####
####      ##    ##    ####    ##
######  ##    ##  ##    ####  ##
####        ##      ##    ##  ##
##    ##  ##    ##      ##    ##
##  ##      ##    ##  ##    ####
##    ####    ####      ##    ##
####      ##        ##      ##  
################################
