################################
                  ##          ##
####  ##  ##  ##      ######  ##
##    ##  ##    ##  ##        ##
########    ##  ####  ##  ##  ##
##      ##    ##        ####  ##
##  ##  ####  ##  ####  ##    ##
##  ##        ##  ##      ##  ##
##    ######  ##    ##  ##    ##
####  ##  ##    ######    ######
##    ##  ##  ##      ##      ##
##  ##            ##    ####  ##
##    ############    ##  ##  ##
####  ##        ######        ##
##        ####          ##  ##  
################################
