################################
  ##          ##              ##
##    ######      ##  ####  ####
##  ##      ##  ##  ##        ##
####    ##  ##      ##  ####  ##
##    ####    ####  ##    ##  ##
####  ##    ##      ####  ##  ##
##    ##  ##    ####      ##  ##
##  ##      ####      ####    ##
##    ####  ##    ########  ####
####  ##        ##    ##      ##
##      ############      ##  ##
##  ##          ################
##    ########    ##      ##  ##
####          ##      ##        
################################
