################################
  ##      ##      ##      ##  ##
##    ##      ####    ##      ##
##  ##    ##  ##    ##  ####  ##
##  ##  ####      ##        ####
##    ####    ####    ####    ##
####      ##    ##  ########  ##
##  ####  ##  ##      ####    ##
##          ##    ####      ####
####  ##  ##    ####    ####  ##
####  ##    ##  ##    ##      ##
##    ####  ##  ##  ####  ##  ##
##  ##      ##  ##      ##    ##
##  ##########  ########    ####
##                        ####  
################################
