################################
    ##      ##            ##  ##
##  ##  ##  ####  ######      ##
##  ##  ##      ##      ####  ##
##  ##  ##  ##      ##  ##    ##
##  ##    ######  ##        ####
##  ####    ##  ##  ##  ##    ##
##    ##  ##          ##    ####
####    ##  ####  ##  ##  ##  ##
##  ##          ##    ##      ##
##    ##  ####      ########  ##
####      ##    ##  ####      ##
##    ####  ########      ######
##  ####        ####  ####    ##
##        ####              ##  
################################
