################################
  ##      ##                  ##
##    ##      ##  ##  ######  ##
##  ##  ######  ##        ##  ##
####    ##        ##########  ##
####  ##    ####              ##
##      ##    ####  ####  ##  ##
##  ####  ##      ##  ####    ##
##  ##      ####  ##        ####
##      ##    ##    ############
############  ####          ####
##      ####    ##  ##  ##    ##
##  ##      ##  ####  ######  ##
##    ####              ####  ##
####      ##  ####  ##          
################################
