################################
  ##      ##      ##          ##
##    ##      ##  ##  ######  ##
####  ##  ####    ##      ##  ##
##      ####    ########  ##  ##
########      ######      ##  ##
##        ##    ##    ####    ##
##  ######    ##    ####  ##  ##
##  ##  ##  ##    ##      ##  ##
##  ##      ##  ##    ####    ##
##    ##  ##    ##  ##  ####  ##
####  ####  ##  ##  ##    ##  ##
##          ##  ##  ####      ##
####  ####  ##  ##      ####  ##
##      ##        ####          
################################
