################################
  ####    ##  ####      ####  ##
####    ##          ##        ##
##    ##    ####  ##  ######  ##
##  ##    ##  ##  ##          ##
##    ##      ##    ##  ########
##  ##    ####  ##    ##      ##
##      ##      ####      ##  ##
##  ##      ##      ######    ##
####  ############  ##      ####
##          ##      ##  ####  ##
##  ##  ##  ##  ####    ##    ##
##    ##  ####      ########  ##
####          ##  ####  ##    ##
##    ##  ##                ##  
################################
