################################
  ##                ##    ##  ##
##    ####  ######    ##      ##
####  ##  ##      ##  ##  ######
##    ##      ####    ##      ##
####      ######    ##    ##  ##
##    ##  ##      ##  ######  ##
##  ##  ##    ####            ##
##  ##  ##  ####  ##  ##  ######
##      ##        ######      ##
######    ########      ####  ##
##  ##  ##          ##        ##
##  ##    ##  ####    ######  ##
##    ##  ######    ##    ##  ##
####              ######        
################################
