################################
  ##    ##          ##        ##
##    ##    ##  ##  ##  ########
##  ####  ##    ##  ##        ##
##          ##  ##  ##  ####  ##
##  ########    ##  ####      ##
##  ##      ##  ##      ####  ##
##  ##  ####      ####  ##    ##
##  ##  ##    ####          ####
##  ##  ####      ####  ##    ##
##  ##    ##  ##      ##  ##  ##
##    ##  ####    ##      ##  ##
##  ##        ##  ####  ##    ##
####    ####    ##      ##  ####
##    ########      ####        
################################
