################################
          ##            ##    ##
##  ####    ####  ####    ##  ##
##      ##  ##    ##  ##  ##  ##
####  ####  ####  ##  ##  ##  ##
####  ##      ##  ##  ##      ##
##    ##  ####    ##      ##  ##
##  ####        ##    ##    ####
##      ########    ######    ##
##  ##  ##        ##  ##  ##  ##
##  ##    ##  ####          ####
##    ##    ##      ######    ##
##  ######    ####  ##    ##  ##
##    ##    ##      ##  ##    ##
####    ##      ##      ##  ##  
################################
