################################
        ##  ##      ##    ##  ##
##  ##      ##  ##    ##      ##
##  ######  ##  ####      ##  ##
####        ##      ######    ##
##    ####    ####  ##    ##  ##
####      ####      ##  ####  ##
##    ####      ####    ##    ##
####  ##    ######    ##    ####
##    ##  ##        ##  ##  ####
##  ##      ##  ##      ##    ##
##    ####  ##    ####    ##  ##
####    ##  ####    ##  ##    ##
######    ##  ####  ####    ####
########                  ####  
################################
