################################
      ##                      ##
##  ##    ##  ##  ####  ##  ####
##    ##    ##  ##    ##      ##
####      ##      ##  ##  ##  ##
##  ######    ##  ##  ##    ####
##          ####  ##  ####    ##
##  ####  ####    ##    ##  ####
##      ##      ##  ##  ##  ####
######    ##  ##        ##    ##
##  ##  ####      ######  ##  ##
##  ##      ######            ##
##    ####      ########  ##  ##
####      ####          ##    ##
##    ##        ##  ##      ##  
################################
