################################
      ##            ##  ##    ##
##  ##    ####  ##  ##      ####
##      ##    ##        ##  ####
####  ##  ##    ##  ####      ##
####        ##    ##    ####  ##
##  ####  ##  ##      ##      ##
##    ##  ##    ##  ##    ######
####  ##    ##      ##  ##    ##
####    ##    ####  ##    ##  ##
##    ##    ##        ##      ##
##  ########    ####    ####  ##
##    ##    ##      ##    ##  ##
####    ##      ##    ####    ##
######      ##    ##        ##  
################################
