################################
    ##      ##            ##  ##
##      ##    ##  ######      ##
##  ##  ####          ####  ####
####        ####  ##    ##  ####
##    ####      ##  ##  ##    ##
##  ####    ####      ##  ##  ##
##  ##    ##      ##          ##
##    ##  ##  ####  ########  ##
####    ##    ##              ##
##    ##    ##    ####  ##  ####
##  ##    ##  ##  ##  ##      ##
##  ##  ##      ####  ##  ##  ##
##  ##      ##  ##    ####    ##
##    ##  ##        ##      ##  
################################
