################################
  ##  ##          ##          ##
##    ##  ######      ####  ####
##  ####      ########        ##
##  ##  ##  ##      ##  ########
##          ##  ##  ##        ##
##  ######  ##  ##  ##  ####  ##
##        ####  ##  ######    ##
##########      ##        ##  ##
##      ##  ####  ##  ##  ##  ##
##  ##      ##      ##    ##  ##
##  ####  ##  ####      ##    ##
##      ##          ##    ##  ##
##  ##    ##########  ##  ##  ##
##    ##              ##        
################################
