################################
        ##        ####      ####
##  ##  ##  ####        ##    ##
##    ####      ##  ####    ####
####      ####    ##  ####    ##
####  ##    ##  ##        ##  ##
##      ##    ##  ##  ##      ##
##  ####    ##      ##    ######
##  ##    ##    ##      ####  ##
##    ##    ##    ######      ##
####  ##  ######  ##      ##  ##
####  ##    ####  ####  ####  ##
##    ##  ##            ##    ##
##  ##  ##    ##########    ####
##          ##            ####  
################################
