################################
  ##        ######          ####
##    ####    ##    ##  ##    ##
####      ####    ##    ####  ##
##  ##  ##  ######  ##      ####
##  ##  ##            ####    ##
##  ##  ##  ##  ##  ##      ####
##  ##    ##    ##  ##  ##  ####
##    ##  ####  ##      ##    ##
####  ##        ############  ##
##      ##  ####        ##    ##
##  ##    ##  ##  ##  ##    ####
##  ##  ##        ##  ##  ######
##  ####    ##  ####        ####
##        ##        ##  ##      
################################
