################################
      ##    ######        ######
##  ######    ##    ####    ####
##  ####    ##    ##    ##    ##
##        ##    ##  ##    ##  ##
##  ######    ##        ##    ##
##      ##  ##########    ##  ##
######  ##    ##        ####  ##
##        ##      ##  ##      ##
##  ######  ######    ##  ##  ##
##  ##          ##  ##    ##  ##
##      ######    ##    ##    ##
########    ##  ##    ##    ####
##      ##  ##  ##  ##    ######
##  ##              ##  ######  
################################
