################################
  ####          ##          ####
####    ########    ######    ##
##    ##          ##      ##  ##
##  ##  ##  ########  ##  ##  ##
##  ##      ##        ##  ##  ##
##      ####    ########      ##
##  ####    ##  ##      ####  ##
##    ##  ####  ##  ##    ##  ##
####      ##      ##  ##    ####
##  ##  ##    ##  ##    ##    ##
##      ##  ####      ######  ##
##  ####    ##    ####  ##    ##
##  ##  ##    ####      ##  ####
##        ##        ##          
################################
