################################
  ##              ##        ####
##    ####  ##  ####  ####    ##
##  ##  ##    ##      ##  ##  ##
##  ##    ##      ####    ##  ##
##    ##  ####  ####    ####  ##
##  ####      ##      ##      ##
##      ####      ##    ##  ####
##  ##      ##  ######  ##    ##
####    ##      ####  ##  ##  ##
##    ######  ##          ##  ##
######  ##  ##    ######      ##
##          ##  ##      ##  ####
##  ##  ####    ####  ##      ##
####          ##          ##    
################################
