################################
  ##      ##      ##          ##
##  ####  ######      ####  ####
##    ##        ##  ##  ##    ##
##  ##  ##  ##      ##      ####
##  ##    ##  ####  ##  ####  ##
##      ##        ##    ##    ##
##  ##      ####  ##  ##    ####
####    ####      ##  ####    ##
##    ##      ##  ##    ####  ##
##  ##    ##  ####  ##        ##
####    ######        ##  ##  ##
##    ##  ##    ####  ##  ##  ##
####      ##  ##  ##    ##    ##
##    ##            ##      ##  
################################
