################################
  ##      ##  ##  ########    ##
##    ####          ####    ####
##  ##      ##  ##        ##  ##
##  ##  ##    ##  ##  ##  ##  ##
##  ##    ####    ##  ##      ##
##    ##        ##    ##  ##  ##
####    ##  ##  ####  ##    ####
##  ##    ##      ##  ####    ##
##      ##    ##  ##      ##  ##
##  ##  ##  ##  ##  ####  ##  ##
##  ##  ##  ##        ##    ####
##    ##    ##  ####    ##    ##
####  ####  ##    ######    ####
##            ##          ####  
################################
