################################
  ##                ####      ##
##    ##  ####  ####      ##  ##
####    ##  ##    ##  ####    ##
##  ##      ####          ##  ##
##    ####      ########  ##  ##
##  ##    ##  ##        ##    ##
##      ##    ##  ####      ####
####  ##    ####    ######    ##
##    ##  ##    ##        ##  ##
####  ##      ######  ##  ##  ##
##      ####    ##    ##  ##  ##
##  ##  ####  ##  ##  ##  ##  ##
##  ##        ##    ####  ##  ##
##    ##  ##    ##        ##    
################################
