################################
          ####              ####
##  ####        ##  ##  ##    ##
##    ######  ##    ##    ##  ##
##  ##      ##  ##    ##    ####
##  ##  ##        ##    ##    ##
####    ########    ##  ##  ####
##    ##        ##    ####    ##
##  ##  ##  ####  ##      ##  ##
##  ##              ####  ##  ##
##    ##  ##  ####        ##  ##
####    ##  ######  ######    ##
##    ##      ##    ##      ####
##  ##    ##  ####  ######    ##
##      ######              ##  
################################
