################################
  ##          ##              ##
##    ######    ####  ######  ##
##  ##    ####      ##        ##
##    ##        ##  ####  ##  ##
##  ############          ##  ##
##    ##        ####  ####    ##
##  ##    ####    ##    ##  ####
##    ##      ##  ####    ######
##  ##  ####  ##      ##    ####
##      ####    ##  ##  ##    ##
####  ##      ##        ####  ##
##    ##  ####  ####  ##      ##
##  ##    ##        ##    ##  ##
##      ##    ####      ##      
################################
