################################
            ##            ##  ##
##  ######    ##  ######      ##
##        ##  ##  ##    ####  ##
######  ####          ##      ##
##  ##      ########  ##  ######
##    ####  ##    ####    ##  ##
##  ####    ##  ##      ##    ##
##  ##    ##      ####  ##  ####
##    ##  ##  ##      ##      ##
####      ##  ##  ##      ##  ##
##    ##  ##  ##    ######    ##
##  ##      ######  ##  ####  ##
####    ##    ##    ##        ##
##    ######      ##    ##  ##  
################################
