################################
        ##              ########
##  ##    ##  ##  ####    ######
##    ##      ####    ##    ####
##  ##    ##      ##    ##    ##
##  ######  ##  ####  ##    ####
##          ####      ##  ##  ##
##  ####  ##      ##  ##      ##
####      ##  ########  ####  ##
##    ##  ##  ##  ##    ##    ##
##  ##  ##    ##      ##    ####
##          ##  ##  ##  ##    ##
####  ##  ####            ##  ##
##  ##  ##      ######  ##    ##
##          ##      ##      ##  
################################
