################################
          ##  ##          ######
####  ##        ##  ####    ####
##    ####  ##    ##    ##    ##
####    ##    ##    ##    ##  ##
##  ##    ##    ##    ##      ##
##  ####    ##    ##  ##  ##  ##
##    ##  ##  ##  ##      ##  ##
####  ##      ##  ##  ######  ##
####    ####  ##    ##      ####
##    ##      ##  ##    ##  ####
##  ######  ##    ##  ####    ##
##    ##      ##          ##  ##
####      ####  ##########    ##
##    ##    ##              ##  
################################
