################################
  ##                ##        ##
##    ##  ##  ####    ##  ##  ##
##  ##    ##    ####      ##  ##
##    ####  ##      ##  ##    ##
####        ##  ##    ####  ####
##  ######    ##  ##      ##  ##
##        ##      ######  ##  ##
##  ####    ##  ##    ##      ##
####      ####  ####    ####  ##
##    ##  ##        ##    ##  ##
##  ##    ##  ##  ####  ##    ##
##  ##  ##      ##      ##  ####
##  ####    ##  ##  ####      ##
##        ##    ##        ##    
################################
