################################
  ######      ##  ##      ##  ##
######    ##          ##      ##
####    ##    ##############  ##
##    ####  ##        ##      ##
##  ####    ##  ##  ##    ######
####      ##  ##      ##  ##  ##
##    ####      ####  ##  ##  ##
####  ##    ##    ##      ##  ##
##      ##    ##  ##  ####    ##
##  ##    ##  ##            ####
####  ##  ##    ##  ##  ##    ##
##        ############    ##  ##
##  ######      ##    ##    ####
##          ##      ######      
################################
