################################
    ##          ##      ##    ##
##  ##  ######    ####      ####
##  ##  ##    ##    ####  ##  ##
##    ##    ######    ##      ##
####      ##  ##    ##    ##  ##
##    ##      ##  ##  ##  ##  ##
####    ####  ##  ##    ##    ##
##  ##    ##  ##  ####    ##  ##
##      ##    ##      ##      ##
##  ####    ####  ##    ##  ####
##  ##    ##        ####      ##
####    ##  ##  ##        ##  ##
##    ##      ##  ########    ##
####      ##                ##  
################################
