################################
  ##      ##                  ##
##    ####  ##  ####  ####  ####
##  ##      ##      ##        ##
##      ####  ####    ####  ####
##  ######      ##  ##      ####
##  ##      ##    ##    ##    ##
##  ####  ##  ##    ##    ##  ##
##        ##    ##  ##  ##    ##
##########  ##      ##    ######
##          ##  ####  ##      ##
##  ##  ####          ######  ##
##  ##      ##  ####          ##
##    ####    ##  ##########  ##
####      ##                    
################################
