################################
    ####          ##  ##  ##  ##
##        ######              ##
##  ##  ##      ####  ######  ##
##  ##  ##  ##      ##    ##  ##
####    ##  ##  ##    ##      ##
####  ##  ##    ####    ##  ####
##    ##    ##    ####  ##    ##
##  ######    ##      ##  ##  ##
##    ##  ##    ####  ##      ##
####      ####        ##  ######
##  ####      ####  ####  ##  ##
##    ######  ##          ##  ##
##  ##      ##    ##  ####    ##
##      ##      ##          ##  
################################
