################################
      ##  ##          ##  ##  ##
##  ##      ##  ####  ##      ##
##      ####      ##      ##  ##
##  ####  ##  ####  ##  ####  ##
##  ##        ##      ##      ##
##      ##  ####  ##  ##  ######
########  ##      ####    ##  ##
##    ##      ####      ####  ##
##  ####  ##    ##  ####      ##
##  ##    ##  ####  ##    ##  ##
##  ##  ##    ##        ##    ##
##        ##    ####  ##    ####
####  ##    ##    ####    ######
##      ##    ##        ######  
################################
