################################
                ##            ##
####  ########    ##  ##  ##  ##
##    ##      ##  ##  ##    ####
##  ##  ##  ##    ##  ####    ##
##  ##          ####      ##  ##
##    ##  ######    ##  ##    ##
##  ##          ##      ##  ####
##    ####  ##    ####  ##    ##
####  ######  ##      ######  ##
####    ##      ####    ##    ##
##  ##      ####    ##    ##  ##
##    ######      ##    ##    ##
##  ####      ######  ##    ####
##        ##              ####  
################################
