################################
          ##          ##      ##
##  ####  ##  ####  ##  ##  ####
##      ##    ####      ##  ####
##  ####    ##    ######      ##
##    ##  ##    ##    ##  ##  ##
####  ##      ##  ##      ##  ##
####    ####        ##  ####  ##
##    ##  ####  ##  ####      ##
##  ##        ####    ##  ##  ##
##  ##  ####      ##      ##  ##
##  ##  ##  ####    ##  ##    ##
##  ##  ##      ##    ######  ##
##  ##      ##    ##    ##    ##
##      ##    ##    ##      ##  
################################
