################################
  ####          ##            ##
####    ######    ##  ####  ####
##    ##      ##    ####      ##
##  ##    ##  ####  ##    ##  ##
##  ##  ####    ##    ##    ####
##  ##      ##    ##    ##    ##
##  ##  ##  ####  ##  ######  ##
##  ##  ##      ####    ##    ##
##  ####    ##      ##      ####
##      ##    ##  ##    ####  ##
######    ####      ####      ##
##    ##    ##  ##        ##  ##
##  ##  ##  ##    ##  ##    ####
##              ##      ##      
################################
