################################
      ##                  ######
##  ##    ########  ####    ####
##  ##  ##        ##    ##    ##
##        ##  ##      ##  ##  ##
##  ##  ##    ##  ##      ##  ##
##  ####    ##  ####  ####    ##
##    ##  ##                ####
##  ####  ##  ####  ##  ##    ##
####      ##  ##  ##  ######  ##
##    ##    ##    ##    ##    ##
####    ######  ##  ##    ##  ##
##  ##          ##    ##  ##  ##
##  ##  ########    ##        ##
##              ##      ##  ##  
################################
