################################
    ##          ##            ##
##      ##  ##  ##  ##  ##  ####
##  ##  ##    ##    ##  ##    ##
##  ####  ##  ##  ####    ##  ##
####          ##  ##  ##    ####
##    ##  ######  ##    ##  ####
##  ######        ####  ##    ##
##  ####    ######        ##  ##
##        ##        ##  ####  ##
####  ######  ######  ##      ##
##    ##      ##      ##  ##  ##
##  ##    ##  ##  ##      ##  ##
##    ##  ##  ##  ##########  ##
####      ##  ##            ##  
################################
