################################
  ####          ##            ##
####    ######    ####  ####  ##
##    ##      ##      ####    ##
##  ####  ##    ####      ##  ##
##  ##    ####      ####      ##
##  ##  ##  ######    ##  ##  ##
##  ##  ##        ##    ####  ##
##  ##    ##  ##  ####  ##    ##
##    ##  ##    ##      ##  ####
##  ##    ##  ##    ####    ####
##    ##  ##    ####    ##    ##
##  ##      ##        ####  ####
##  ##  ####    ##  ####      ##
##      ##    ##          ##    
################################
