################################
                  ##  ##      ##
##  ##########  ##        ######
##  ##      ##      ####      ##
##  ######    ########    ##  ##
##          ####      ####    ##
##########  ##    ##        ####
##      ##  ##  ##  ######    ##
##  ##      ##  ##        ##  ##
##    ######    ##  ####  ##  ##
##  ##    ##  ####    ##  ##  ##
##      ##          ####  ##  ##
####  ##    ##  ####      ##  ##
##  ##  ####  ##      ####    ##
##                ####      ##  
################################
