################################
  ####  ##            ##      ##
####      ##  ##  ######  ##  ##
##    ##  ####    ##      ##  ##
##  ##          ####  ####    ##
##    ######  ##      ##    ####
####        ##    ##    ##    ##
####  ####  ##  ##  ##    ##  ##
##    ##        ##      ##    ##
##  ##  ##  ####  ##  ##  ######
##  ##    ####      ##    ##  ##
##    ##        ##      ##    ##
##  ##  ######    ####      ####
##  ##        ####      ##    ##
##      ####        ##    ##    
################################
