################################
        ##      ##          ####
##  ##  ##  ##      ##  ##    ##
####    ##    ######      ##  ##
##    ##  ##  ##    ##  ##    ##
##  ##            ##    ##  ####
##      ####  ##  ##  ##      ##
##  ####    ##    ##  ##  ##  ##
##      ##  ##  ####    ##  ####
######  ##  ##  ##    ##      ##
##      ##  ##  ##  ####  ##  ##
##  ####    ##  ##        ##  ##
##    ##  ##    ########  ##  ##
####  ##    ####        ##    ##
##      ##        ####      ##  
################################
