################################
  ####        ##            ####
####    ####      ##  ####    ##
##    ##    ####  ##  ##  ##  ##
####    ##      ##    ##      ##
##    ####  ##      ##    ######
##  ##      ####  ##    ####  ##
####  ######    ##    ##      ##
##            ##    ##    ##  ##
##  ########  ##  ##    ##    ##
##          ##    ##  ####  ####
####  ####    ##  ##      ##  ##
##    ##  ##      ######      ##
####  ##    ##  ##        ##  ##
##        ##        ##  ##      
################################
