################################
  ##  ##      ##    ####      ##
##        ##    ##        ##  ##
##  ####    ##    ##  ######  ##
##  ##  ##    ####          ####
##        ##    ##  ######    ##
##  ####    ##  ##        ##  ##
##    ##  ######    ######    ##
####  ##    ##    ##        ####
##    ####      ####  ##  ######
##  ##    ####  ##    ##    ####
##    ##      ##    ##  ##    ##
####    ####  ##  ##      ##  ##
####  ##      ##  ##  ##      ##
##        ##    ##      ##  ##  
################################
