################################
  ##    ##        ####        ##
##    ##    ####        ####  ##
##  ##  ##      ##  ######    ##
##  ##    ##  ##          ##  ##
##    ##  ##    ########    ####
####  ##    ####        ##    ##
##      ##        ####    ##  ##
##  ##    ####  ####  ##  ##  ##
##    ##    ####      ##  ##  ##
####  ####        ##  ##  ##  ##
####    ####  ##    ##    ##  ##
##  ##    ##  ######    ####  ##
##    ##  ##      ##  ####    ##
####        ####            ##  
################################
