################################
                ########      ##
##  ######  ##    ####    ##  ##
####    ##    ####      ##    ##
##  ##  ####        ##  ##  ####
##  ##    ##  ######  ####    ##
##    ##    ####          ##  ##
####  ##  ##      ##  ##  ##  ##
####      ##  ####  ####  ##  ##
##    ####      ##        ##  ##
####      ##  ##    ##  ####  ##
##    ####    ##  ######      ##
####        ##      ##    ##  ##
##  ##########  ####    ##    ##
##                    ##    ##  
################################
