################################
  ##          ##        ##    ##
##    ##  ##      ####      ####
##  ##  ##  ##  ##    ####  ####
######      ##  ##  ####      ##
##      ####    ##        ##  ##
##  ####      ##    ######    ##
##      ##  ##    ##      ##  ##
##  ##      ####      ##    ####
##    ######    ######  ##    ##
##  ##        ####        ##  ##
####    ####      ##  ##  ##  ##
##    ##      ##        ##    ##
####  ####  ##  ##########  ####
##      ##                      
################################
