################################
            ####          ##  ##
##  ####  ##      ##  ##      ##
##    ######  ####    ######  ##
####            ##  ##        ##
##    ########  ##  ##  ##  ####
######      ##  ##  ####      ##
##      ##  ######      ####  ##
##  ######        ####    ##  ##
##  ##    ##  ##  ##  ##    ####
##  ##  ##  ##    ##    ##  ####
####            ####  ##      ##
##    ##  ######        ####  ##
##  ##  ##      ##  ##  ##    ##
##          ##      ##      ##  
################################
