################################
  ##      ##  ##            ####
##    ##  ##      ####  ##    ##
####  ##  ##  ##      ##  ##  ##
##    ##    ##    ##  ##  ######
##  ##    ##    ##            ##
##  ####  ##  ##  ##  ##  ##  ##
##    ##    ##      ##  ##    ##
####  ##  ##    ####        ####
##    ##      ##    ##  ##    ##
##  ##  ######  ##        ######
##                ##  ##      ##
##  ########  ##    ##    ##  ##
####        ##  ##  ######    ##
##    ####                  ##  
################################
