################################
  ##        ####  ##          ##
##    ####          ##  ##  ####
####  ##  ####  ##      ##    ##
##    ##    ##  ####  ##  ##  ##
####    ##  ##      ##        ##
##    ####    ####    ##  ##  ##
##  ##      ##    ##    ##    ##
##    ##  ##    ##  ##    ##  ##
####          ##      ##  ##  ##
##  ####  ##      ##  ##  ##  ##
##      ##  ##  ##    ##    ####
##  ##        ##    ##  ##    ##
##  ######  ##    ##    ##  ####
##      ##      ######          
################################
