################################
  ##      ##        ##      ####
##    ####    ####    ####    ##
##  ##  ##  ##    ##      ##  ##
##  ##      ##  ##  ##  ##    ##
##    ######        ##    ##  ##
####          ####  ##  ####  ##
##  ##  ####  ##  ####        ##
##        ####        ##  ##  ##
##  ######      ####    ##    ##
##      ##  ####  ##  ##    ####
##  ##      ##    ##      ##  ##
##  ##  ####  ##    ######    ##
##    ####        ####      ####
####        ####        ##      
################################
