################################
  ##  ##                  ##  ##
##        ########  ####  ##  ##
########  ##      ##      ##  ##
##    ####    ##  ##  ####    ##
##  ##      ##    ##      ##  ##
##      ####  ##  ##  ##  ##  ##
##  ######    ##  ##    ##    ##
##          ####    ##  ##  ####
##########  ##  ##      ##  ####
##      ##  ##    ######      ##
##  ##  ##  ####  ##    ####  ##
##    ##      ##      ##      ##
####      ####    ##  ##  ##  ##
##    ##        ##        ##    
################################
