################################
    ##    ##        ####      ##
##      ##    ####        ##  ##
####  ######  ##  ##  ######  ##
####    ##    ##    ##        ##
##    ####  ##    ##    ####  ##
##  ##      ####    ##  ##    ##
##    ####    ####  ##    ##  ##
####      ##    ##    ##  ##  ##
##    ##  ####  ##  ##    ##  ##
##  ####    ##  ##    ##    ####
##      ##      ####    ####  ##
##  ##  ####  ##      ####    ##
####        ##  ####  ##    ####
##    ####                ####  
################################
