################################
  ##    ##  ##  ##        ##  ##
##    ##          ##  ##  ##  ##
##  ##    ##  ##  ##  ##      ##
##      ##  ##    ##    ####  ##
##  ####        ##  ##  ##    ##
##      ##  ##  ##        ######
##  ##    ##      ######      ##
##    ##  ##  ##        ####  ##
####  ##    ########  ##      ##
####    ##    ##  ##      ##  ##
##  ##    ##  ##    ######    ##
##  ##  ##    ##  ##    ##  ####
##      ##  ##      ##        ##
##  ##  ##    ####      ####    
################################
