################################
            ####    ##        ##
##  ######        ##    ####  ##
##  ##    ##  ##  ##  ##  ##  ##
####  ##    ####  ##  ##  ##  ##
##        ##      ##      ##  ##
##  ##  ##    ####    ####    ##
######  ##  ####    ##  ##  ####
##      ##  ##    ##    ##    ##
##  ####      ##  ##  ##  ##  ##
##  ##    ####            ##  ##
##  ##  ##      ########  ##  ##
##        ########        ##  ##
####  ####        ########    ##
##          ####            ##  
################################
