################################
    ##          ##    ##    ####
##      ##  ##    ##    ##    ##
########    ####    ##    ##  ##
##        ##    ##    ##      ##
##  ####  ####      ##  ##  ####
##      ##    ##  ##          ##
##  ####    ##    ##  ##  ##  ##
##  ##    ##    ##  ##    ##  ##
##      ##    ##    ##  ##    ##
####  ######  ####  ##    ##  ##
##  ##  ##      ##      ##    ##
##          ##    ##  ##    ####
##  ########  ##    ##    ######
##              ##      ######  
################################
