################################
  ##        ######        ######
##    ####    ##    ####    ####
##  ##    ##      ##    ##    ##
##  ##  ##  ########  ##    ####
##  ##  ##              ##    ##
####    ##  ##  ##  ####    ####
##    ####    ##        ##    ##
####      ##    ######    ##  ##
##    ##    ##        ##  ##  ##
##  ##  ##    ##  ##  ##      ##
##  ##    ##    ##    ##########
##    ##  ##  ####  ##        ##
####        ##          ####  ##
##    ####      ####  ##        
################################
