################################
  ##  ##            ##    ##  ##
##      ####  ####      ##    ##
##  ##        ##  ##  ##    ####
##    ######  ##  ##      ##  ##
####  ##      ##    ######    ##
####    ########  ##      ##  ##
##    ##          ##  ##      ##
##  ##    ########    ####  ####
##  ##  ##      ##  ##        ##
##  ##      ##  ##    ##  ##  ##
##  ##########    ##  ##  ##  ##
##            ##      ####    ##
####  ####  ##  ######      ####
##      ##              ##      
################################
