################################
  ##        ##  ##          ####
##    ####  ##      ####  ##  ##
##  ##      ####  ##  ##  ##  ##
##  ######      ##        ##  ##
##        ####      ##  ##    ##
##  ####      ######    ##  ####
##  ##    ##        ##  ##  ####
####    ##  ######    ##      ##
##    ####  ##    ##      ##  ##
####          ##    ##  ##  ####
##  ########      ##  ##      ##
##        ######        ####  ##
##  ######      ##  ##    ##  ##
##          ##        ##        
################################
