################################
      ##    ##  ##  ##        ##
##  ##    ##          ##  ##  ##
##      ##    ##  ##  ##  ##  ##
##  ######  ##    ##  ##  ##  ##
##          ##  ##    ##  ##  ##
##  ####  ##    ##  ##    ##  ##
##      ####  ##    ##  ##    ##
####  ##      ##  ##    ##  ####
##  ##    ######      ##    ####
##      ##      ##  ##    ##  ##
########    ##  ####    ##    ##
##    ####  ####      ##    ####
####          ##  ####    ######
##    ##  ##            ######  
################################
