################################
  ##          ##        ##  ####
##    ######  ##  ##  ##      ##
##  ##    ##  ##  ####    ##  ##
##  ##  ##    ##        ##    ##
##  ##      ##  ##  ##  ##  ####
##  ##  ##        ##    ##    ##
##    ######  ##    ####  ##  ##
####    ##      ##            ##
##  ##    ######    ####  ##  ##
##      ##      ####    ##    ##
####  ####  ##    ##  ####  ####
##    ##    ####      ##    ####
##  ####  ##  ##########  ##  ##
##        ##                    
################################
