################################
  ##      ##      ######      ##
##    ##      ##    ##    ##  ##
##  ##    ##    ##  ##  ##    ##
######  ##    ####  ##  ####  ##
##    ##    ##        ##      ##
####      ######  ####    ##  ##
##  ######  ##    ##    ##    ##
##  ##        ##      ##    ####
##  ##  ####  ####  ##  ##    ##
##      ##      ####      ##  ##
##  ####  ####        ##      ##
##  ##        ############  ####
##    ####  ####      ##  ##  ##
####              ##            
################################
