################################
  ##        ##  ##      ##    ##
##    ####          ##      ####
##  ##    ##  ####    ####    ##
##      ####  ##  ##  ######  ##
##  ######        ##    ####  ##
####      ##  ##    ##      ####
##    ##    ####  ########    ##
##  ##  ##  ##      ##    ##  ##
##  ##  ##    ####      ##    ##
##  ##    ##  ##  ####    ##  ##
##    ##  ##  ##        ####  ##
####  ##        ##  ####      ##
##    ####  ##  ####      ##  ##
####      ##          ####      
################################
