################################
        ##  ##  ##        ##  ##
####  ##          ##  ##      ##
####      ##  ##      ####  ####
##    ####  ##  ######  ##  ####
##  ##          ##      ##    ##
##    ######  ##    ##    ##  ##
####              ######  ##  ##
##  ##  ##  ####    ##  ####  ##
##    ##  ##      ##          ##
##  ##        ####    ##  ##  ##
##  ##  ######      ##  ####  ##
##  ##      ##  ####    ##    ##
##  ######  ##  ##    ##    ####
##          ##      ##    ####  
################################
