################################
  ##                    ##  ####
##    ##  ####  ##  ##  ##    ##
##  ##        ##  ####  ####  ##
##    ##  ####    ##          ##
##  ##    ##    ##    ##  ##  ##
##    ##    ##    ########    ##
####    ##    ##      ##    ####
##    ##  ##    ####    ####  ##
##  ##    ##  ##  ##  ##      ##
##  ####  ##  ##  ##      ##  ##
##        ##        ##  ##    ##
##  ####  ##  ##  ##  ##    ####
####        ##    ##  ##  ##  ##
##    ####    ##                
################################
