################################
  ##  ##            ##  ##    ##
##    ##  ########          ####
##  ##    ##      ##  ##  ##  ##
##  ##  ##    ##    ##        ##
##  ##    ##    ##    ####  ####
##  ####    ##    ##          ##
##      ##    ##    ########  ##
##  ##      ##  ##        ##  ##
####  ####      ########    ####
##        ##  ##        ##    ##
##  ####    ##    ##  ##    ####
##    ####    ##  ##    ##    ##
######      ##    ####  ####  ##
##      ##      ##              
################################
