################################
  ##      ##    ##      ##    ##
##    ##    ##      ##      ####
####    ##    ##  ##    ##    ##
##    ##  ##    ##  ####    ####
##  ##      ##        ##  ##  ##
##  ####  ##  ##  ##  ##      ##
##            ##  ##      ##  ##
########  ##  ##  ##  ##    ####
##      ##    ##  ##    ##    ##
##  ##  ##  ##      ####  ######
##  ##    ##  ####            ##
##    ####      ##  ########  ##
####  ##    ##  ####          ##
##        ##          ##  ##    
################################
