################################
    ##  ##  ##  ##            ##
##  ##  ##          ##  ##  ####
##      ##  ########    ##    ##
##  ####    ##      ####  ##  ##
##    ##  ##    ##        ##  ##
####  ##    ##  ##  ####      ##
##    ##  ####  ##    ####  ####
##  ##  ##      ####    ##    ##
##      ##  ####    ##    ##  ##
##  ##  ##  ##  ##  ####    ####
####    ##  ##        ####    ##
##    ##    ##  ####      ##  ##
##  ##    ##        ####      ##
##      ##    ####      ##  ##  
################################
