################################
  ####  ##          ##        ##
####      ##  ##  ##    ####  ##
##    ##    ##        ######  ##
##  ######      ##  ######    ##
##    ####  ##    ##  ##    ####
####      ##  ##  ##    ####  ##
####  ##      ##    ##        ##
##    ######    ####  ##  ##  ##
####      ####          ##    ##
##  ####    ######  ##    ##  ##
##        ##        ##  ##    ##
##  ##  ##    ####    ##    ####
####      ##  ##  ####    ######
##    ##  ##            ######  
################################
