################################
  ##        ##      ##  ##    ##
##    ####  ##  ##          ####
##  ##        ##    ####  ######
##    ##  ##  ##  ##  ##    ####
####  ####      ##      ##    ##
##        ####  ##  ##    ##  ##
##  ####    ##        ##      ##
####      ##    ######  ####  ##
####  ##    ####            ####
##    ##  ##      ##  ####    ##
##  ##    ##  ####  ##    ##  ##
##    ##  ##    ##    ##      ##
####    ##  ##  ##  ##    ##  ##
######          ##      ##      
################################
