################################
  ####    ##  ##            ####
####    ##        ####  ##    ##
##    ####  ####  ##    ##  ####
##  ##      ##  ##    ####    ##
##  ##  ####      ##  ##    ####
##      ##  ####  ##  ####    ##
##  ##            ##      ##  ##
##  ########  ##  ######  ##  ##
####      ##  ####        ##  ##
####  ##  ##    ##  ######    ##
##      ##  ####    ##    ##  ##
##  ##  ##      ##    ##      ##
####        ##    ##  ##  ######
##    ####    ##      ##        
################################
