################################
        ##  ##                ##
##  ####      ##  ##  ####  ####
##    ##  ##        ##        ##
##  ##    ########    ##  ##  ##
##      ##        ##    ##    ##
##  ##  ##  ##  ##  ##  ##  ####
####    ####        ##  ##    ##
##    ##      ########    ##  ##
##  ##    ##  ##      ##    ####
##    ##  ##  ##  ##    ##    ##
####    ##    ##    ########  ##
##  ##    ##    ##      ##    ##
##      ####  ##    ####    ####
##  ##          ##        ####  
################################
