################################
  ##        ##        ######  ##
##    ####    ######    ##    ##
##  ##    ##      ####      ####
##    ##    ####      ####    ##
##  ##  ##      ####      ##  ##
####    ##  ##  ##  ####      ##
##    ####  ##          ####  ##
##  ##      ####  ##  ####    ##
##  ##  ####    ##    ##    ####
##  ##        ####  ##    ##  ##
##    ####  ##        ##  ##  ##
##  ##      ##  ##  ##        ##
##  ##  ####    ####    ##  ####
##          ##        ##        
################################
