################################
      ##            ##      ####
##  ##    ####  ##    ####    ##
##  ##  ##        ##      ##  ##
##      ##  ######  ####      ##
####  ####  ##        ##########
##    ##    ##  ####          ##
##  ##    ####      ####  ##  ##
##    ##      ####      ##    ##
####    ####      ####  ##  ####
##    ##  ##  ##  ##    ####  ##
##  ##    ##    ##    ##      ##
##    ##    ##  ##  ##    ##  ##
####    ##  ##  ##  ##  ##    ##
######      ##          ##  ##  
################################
