################################
  ##        ##        ##    ####
##    ####      ####    ##    ##
##  ##    ##  ##    ##    ##  ##
##      ##        ##  ##      ##
##  ##    ######        ####  ##
####  ####      ####  ##      ##
##      ##  ##      ##    ##  ##
##  ##      ######    ##    ####
##    ######      ##    ##    ##
####      ######    ##  ####  ##
##    ##        ##        ##  ##
##  ##    ####  ####  ##      ##
##    ####  ##      ##  ####  ##
####          ####      ##      
################################
