################################
  ##        ##        ##      ##
##    ####    ##  ##    ##  ####
##  ##    ##        ####      ##
##      ##    ####        ##  ##
####  ##  ##  ##  ##  ####    ##
##    ##  ##      ####    ##  ##
##  ##    ######        ##    ##
##    ##        ##  ##    ##  ##
####  ######  ##  ##  ##  ##  ##
####      ##            ##    ##
##  ####    ##########      ####
##        ####        ######  ##
##  ######      ##  ####      ##
##          ####          ##    
################################
