################################
  ##    ##  ##              ####
##    ##        ####  ####    ##
##  ##    ######  ##  ######  ##
##      ##        ##    ##    ##
####  ##    ####  ####    ##  ##
##        ##  ##    ####    ####
####  ####      ##    ####    ##
##  ##      ##    ##    ####  ##
##    ##  ######      ##      ##
####    ################  ##  ##
##  ##    ######          ##  ##
##    ##    ##    ########    ##
####  ##  ##    ##      ##  ####
##            ##    ##          
################################
