################################
  ##          ##  ##        ####
##    ####  ##      ##  ##    ##
##  ########    ##      ########
##  ######    ##  ##  ##      ##
##    ##    ##      ##    ##  ##
####      ##    ##  ##  ##    ##
##  ##  ##    ####  ##  ##  ####
##        ######    ##  ##  ####
####  ##          ##    ##    ##
##      ##  ##  ##    ##  ##  ##
####  ##      ####  ##        ##
##    ########        ####  ####
####        ##  ####    ####  ##
##    ####          ##          
################################
