################################
      ####          ####    ####
####        ######      ##    ##
##  ##  ####      ####    ##  ##
##  ##      ##  ##    ##      ##
##      ####      ##    ####  ##
########      ##      ##      ##
##      ##  ##  ##  ##    ######
##  ##  ##        ##    ##    ##
##  ##    ######  ##  ####  ####
##    ##          ##        ####
####  ##########    ##  ##    ##
####          ##  ##  ######  ##
##    ##  ##    ##      ##    ##
##  ##      ##      ##      ##  
################################
