################################
  ##            ##  ##        ##
##    ##  ##  ##    ##  ####  ##
####  ##  ##      ####    ##  ##
##    ##    ##  ####    ##    ##
##  ##    ######      ##  ##  ##
######  ######    ######  ##  ##
##        ##    ##        ##  ##
##  ####  ##  ##    ########  ##
##  ######    ##  ####        ##
##    ##    ##    ##    ##  ####
####    ##      ##    ######  ##
##  ##    ##  ####  ######    ##
##      ##  ####      ##    ####
##  ##            ##      ####  
################################
