################################
    ##  ##        ##          ##
##          ####      ##  ##  ##
##  ####  ##    ######  ##    ##
##    ##  ##  ####  ##  ##  ####
##  ##    ##            ##  ####
####    ##  ##  ##  ######    ##
##    ####      ####        ####
####  ##    ##    ##  ######  ##
####    ##    ##  ##  ##      ##
##  ##    ##  ##  ##      ##  ##
##  ####    ##    ######  ##  ##
##      ##    ##        ##    ##
##  ##    ####  ##  ####    ####
##    ##                  ####  
################################
