################################
          ##            ##    ##
####  ####    ########  ####  ##
####  ##    ##      ##        ##
##    ##  ##    ####  ####  ####
##  ##  ##  ##          ##    ##
##          ##  ######    ##  ##
####  ##  ##    ##    ##  ##  ##
####  ##  ##  ##    ####      ##
##    ##  ##    ##      ########
##  ##      ##    ####        ##
##  ########  ##    ##  ####  ##
##              ##        ##  ##
####  ######  ##  ########    ##
##        ##                ##  
################################
