################################
                  ##      ##  ##
##  ####  ##  ##  ##  ##      ##
##      ##  ##    ##    ##  ####
##  ##      ##  ##    ##      ##
####  ##  ##    ##  ##    ##  ##
##    ##  ##  ####    ##    ####
##  ##    ####    ##  ####    ##
##  ##  ##      ####      ##  ##
##      ##  ##      ##  ##    ##
####  ##    ####  ##    ##  ####
##    ####    ####    ##      ##
####    ####        ##    ##  ##
##  ##      ##########  ##    ##
##      ##              ##  ##  
################################
