################################
  ##      ####      ##        ##
##    ##        ##  ####  ##  ##
##  ##  ####  ##          ##  ##
##      ##    ####  ######    ##
####  ##  ##      ##      ##  ##
##    ##  ##  ##  ##  ##  ##  ##
##  ####  ##  ##  ##    ##    ##
##  ##    ##  ##    ##      ####
####    ####    ##    ##  ##  ##
##    ##      ##    ##    ##  ##
####  ##  ##  ##  ######      ##
##      ##  ##      ##  ####  ##
##  ####      ####  ##  ####  ##
##        ##        ##          
################################
