################################
  ######    ##      ####      ##
######    ####  ##        ##  ##
####    ##        ######  ##  ##
##    ##  ##  ####      ##    ##
##  ##    ##  ##    ##  ##  ####
##  ##  ####    ####    ##    ##
##          ##    ##  ##  ##  ##
##  ####  ##  ####        ##  ##
##    ##      ##    ##  ##    ##
##  ##  ####      ######    ####
##          ##  ##  ##    ##  ##
########  ##    ##  ##  ##    ##
##        ##  ##            ####
##  ##  ##        ##  ####      
################################
