################################
  ####  ##      ##            ##
####      ####    ##  ##  ##  ##
##    ##  ##  ##      ##  ##  ##
##  ##        ##  ##  ##  ##  ##
##    ######    ##  ##    ##  ##
####      ####        ##    ####
##    ##      ######    ##    ##
##  ##  ##  ##        ##  ##  ##
##  ##  ##    ##  ####    ##  ##
##  ##  ##  ##        ##      ##
##      ##  ##  ##  ##    ##  ##
######  ##    ####      ####  ##
##  ##  ####      ######      ##
##          ####        ##  ##  
################################
