################################
        ####      ##  ##      ##
##  ##        ####        ######
##    ##  ######    ##  ##    ##
####  ####        ##      ##  ##
##      ##  ##  ##  ####      ##
##  ##  ##  ####        ########
####    ##      ##  ##        ##
##    ########    ##    ##  ####
##  ##  ##  ##  ##    ##    ####
##  ##      ##    ##    ##    ##
##      ##  ####    ##    ##  ##
##  ######      ##    ##  ##  ##
##  ##    ####  ####  ####    ##
##      ##                  ##  
################################
