################################
    ##      ####    ##        ##
##      ##        ##    ####  ##
####  ##  ##  ##  ######      ##
##    ##    ##        ##  ######
####    ##    ######  ##      ##
####  ##  ##      ##  ##  ##  ##
##    ##  ##  ##        ##    ##
##  ##    ##  ##  ####      ####
##    ##  ##    ####  ####    ##
##  ####      ##      ##    ####
##  ##    ####    ####    ##  ##
##    ########  ##      ##    ##
####      ##    ##  ####    ####
##    ##      ##          ####  
################################
