################################
    ##            ##  ##      ##
##    ####  ####  ##      ##  ##
####          ##    ##  ####  ##
##    ######    ##  ##      ####
####  ##  ####  ##  ##  ##    ##
##    ##      ##    ######  ####
####    ####  ##  ##          ##
##  ##    ##      ####  ####  ##
##  ##  ##  ##  ##          ####
##  ##        ##    ##  ##    ##
##    ##  ##  ##########    ####
##  ##  ####        ##    ##  ##
##          ######      ##    ##
##  ##  ##          ##      ##  
################################
