################################
            ##  ####  ##  ##  ##
##  ##  ##  ##                ##
####    ##    ####  ##  ##  ####
##    ######  ##    ##  ##    ##
##  ##  ##      ##    ##  ##  ##
##  ##  ##  ##    ##  ##  ##  ##
##  ##    ##  ##      ##      ##
##    ##  ##    ######    ######
####  ##  ####          ##    ##
##    ##      ##  ##  ##  ##  ##
##  ##  ####  ##    ####      ##
##        ##    ##        ##  ##
##  ####    ##    ########    ##
##      ##      ##          ##  
################################
