################################
  ##      ##    ####      ##  ##
##    ##    ##        ####    ##
##  ##  ##    ##  ####      ####
##        ##      ##    ##    ##
##  ####    ##  ##    ######  ##
##    ##  ######    ######    ##
##  ##      ##    ##  ##    ####
##    ##  ##    ####  ##  ##  ##
########  ##  ##      ##      ##
##        ##  ##  ####  ##  ####
##  ####  ##      ####  ##    ##
##      ##  ##  ##      ####  ##
##  ####      ##  ##  ##      ##
##        ##              ##    
################################
