################################
  ##                ##        ##
##    ##  ####  ##  ##  ##  ####
##  ##    ##  ####    ##      ##
##    ##  ##      ##  ##  ######
##  ##    ##  ##      ##      ##
####    ##      ######    ##  ##
##    ##    ##  ##      ##    ##
##  ##  ##  ##  ##  ####  ##  ##
##        ##      ####        ##
##  ####  ##  ####      ########
##  ##    ##        ####      ##
##  ##  ##  ########  ##  ##  ##
##  ##                  ##    ##
##    ##  ##  ##  ####      ##  
################################
