################################
      ##                    ####
####      ####  ######  ##    ##
##  ####    ##      ########  ##
##      ####    ##      ##    ##
##  ##      ##    ####  ##  ####
##    ####    ##    ##  ##  ####
####  ##  ##    ######  ##    ##
##          ##          ####  ##
##  ##  ##    ####  ####      ##
##  ##  ##  ##    ##      ######
##    ##      ##      ####    ##
######    ####    ##  ######  ##
##      ####    ##      ##    ##
##  ####      ##    ##      ##  
################################
