################################
  ##          ##    ####      ##
##    ######  ####        ##  ##
##  ##    ##    ##  ######    ##
##  ####  ##  ##    ##      ####
##    ##        ####    ##    ##
####  ########        ##    ####
####          ########    ##  ##
##  ####  ##  ##    ##  ##    ##
##      ##      ##  ##    ##  ##
##  ####    ##  ##      ##    ##
##  ##    ######    ########  ##
##  ##  ##  ##    ##    ##    ##
##    ##      ##  ####      ####
####      ##            ##      
################################
