################################
      ##                      ##
##  ##    ##  ##########  ##  ##
##  ##  ##    ##      ##  ##  ##
##  ##  ##  ##    ##      ##  ##
##        ##    ##  ##  ##    ##
##  ######    ##          ##  ##
##      ##  ####  ########  ####
####  ##    ##    ##        ####
####    ##    ####    ######  ##
##    ##  ##  ##    ##    ##  ##
##  ##    ##      ##    ##    ##
##  ####    ######    ##    ####
##      ##          ##    ######
##  ##      ##  ##      ######  
################################
