################################
          ##      ##      ##  ##
##  ####      ##    ####      ##
##  ##    ##    ##        ##  ##
####    ####  ############    ##
##    ##        ##      ##  ####
####    ##  ####    ##  ##    ##
##  ##  ####    ######    ##  ##
##          ##        ##  ######
##  ##  ##    ##  ##  ##      ##
####    ####      ##  ######  ##
##    ##    ##  ##        ##  ##
##  ######  ##    ####  ##    ##
##    ##      ##      ##    ####
####      ##    ####      ####  
################################
