################################
  ######                      ##
######    ####  ############  ##
####    ##  ##  ##        ##  ##
##    ##        ##  ####      ##
##########  ######      ########
##    ##    ##    ####        ##
####  ####  ##  ##    ######  ##
####        ##      ##        ##
##  ##  ####    ##  ##  ########
##    ##      ####  ##        ##
####      ####        ##  ##  ##
##    ####  ####  ####  ##    ##
####  ##        ##      ##  ####
##        ####      ##          
################################
