################################
  ##    ##            ##      ##
##    ##    ##  ####  ##  ##  ##
##  ##    ##  ####    ##    ####
##      ##          ##  ##    ##
##  ##  ##  ####  ##    ####  ##
##  ##  ##  ##  ######        ##
##    ##          ##  ##  ######
####    ##  ####  ##          ##
##  ##    ##    ####  ######  ##
##    ##  ####        ##      ##
##  ####      ##  ##  ##  ##  ##
##  ##  ####  ##    ####  ##  ##
##      ####  ######      ##  ##
##  ##                ####      
################################
