################################
                ##      ##    ##
##  ####  ##  ##    ##  ####  ##
##  ##    ##      ##      ##  ##
####    ##    ##    ####  ##  ##
####  ##  ####    ##  ##  ##  ##
##    ##        ####  ##  ##  ##
##  ##  ##  ##  ##    ##      ##
##        ##      ##    ####  ##
##  ####  ########  ##      ####
##    ##              ####    ##
####    ########  ##      ##  ##
####  ##      ##    ####  ##  ##
##      ##  ##  ##      ##    ##
##  ##            ####      ##  
################################
