################################
      ##          ##          ##
##  ##    ####  ##    ##  ##  ##
##      ##      ##  ####    ####
##  ##    ####  ##      ####  ##
####  ##    ##    ##  ##      ##
##    ##  ##  ##  ##    ####  ##
##  ##    ##  ##  ####  ##    ##
##  ##  ####  ##    ##      ####
##  ##  ##      ##    ####    ##
##  ##  ##  ####  ##      ##  ##
##  ##      ##      ####  ##  ##
##  ####  ##    ##    ##  ##  ##
##            ##  ##  ##      ##
##  ##  ##  ##          ##  ##  
################################
