################################
  ##              ##        ####
##    ##  ##  ##      ####    ##
##  ##    ####  ######    ##  ##
##  ##  ##      ##      ##    ##
####    ####  ##    ######  ####
##    ##  ##      ####      ####
####  ##      ####      ####  ##
##      ##  ##  ##  ####  ##  ##
########        ##  ##        ##
##        ####  ##    ##  ##  ##
##  ##  ##      ##  ##    ##  ##
####    ########      ##  ##  ##
##    ##      ##  ####    ##  ##
####      ##            ##      
################################
