################################
          ##        ##      ####
####  ##  ##  ####    ####    ##
##    ##  ##      ##      ##  ##
####  ##  ######    ####  ##  ##
####  ##          ##      ##  ##
##  ##    ########  ##  ##    ##
##    ####      ##  ##    ##  ##
##  ##      ##        ##  ##  ##
##      ####  ####  ##    ##  ##
##  ####      ##    ##  ##    ##
##    ##  ##    ##  ##    ##  ##
####  ##    ##  ##      ##    ##
##      ####      ######    ####
##  ##        ##          ####  
################################
