################################
              ##              ##
####  ##  ##    ##  ####  ##  ##
##    ########      ##  ##    ##
####      ##    ####      ######
##    ##    ####      ##      ##
##  ######    ##  ####  ####  ##
##    ######              ##  ##
####    ##  ##  ######  ##    ##
##  ##        ##    ######  ####
##    ##  ##  ##  ##          ##
##  ####    ##      ##  ####  ##
##  ##  ##  ##  ####    ##    ##
##          ##        ##    ####
##  ##  ##    ####  ##    ####  
################################
