################################
  ##  ##    ##            ##  ##
##        ##    ####  ####    ##
##  ####  ########          ####
####  ##          ######  ######
##      ########      ##    ####
##  ##  ##      ####    ##    ##
##  ##      ##      ##    ##  ##
##    ##  ##    ##    ##      ##
####  ##  ##  ##  ##    ####  ##
##    ##  ##      ######  ##  ##
##  ##    ####  ##        ##  ##
##    ##    ####    ##  ##    ##
####  ####      ##  ##      ####
##        ####        ##  ####  
################################
