################################
  ##                        ####
##    ####  ######  ######    ##
##  ##    ##    ##  ##  ##  ####
##  ####      ##    ##        ##
##    ####  ##    ##    ########
####    ##    ##    ####      ##
##  ##      ##  ##        ##  ##
##  ####  ##      ##  ####    ##
##            ##  ####      ####
##  ##  ##  ##      ##  ####  ##
####    ######  ##  ##        ##
##  ####      ######  ####  ####
##    ##  ##    ##            ##
####        ##      ####  ##    
################################
