################################
  ##                ##        ##
##    ####  ######    ####  ####
##  ##      ##    ##    ##    ##
####    ########    ##      ####
##    ##    ######      ####  ##
##  ##  ##    ##    ####      ##
##        ##      ####    ######
##  ####  ##  ####      ##    ##
##      ##        ##  ##    ####
##  ##  ##  ####  ##  ##  ##  ##
##  ##    ####    ##  ##      ##
##    ##      ##  ##  ##  ##  ##
####  ######    ##      ####  ##
##          ##      ##          
################################
