################################
  ##                  ##  ##  ##
##    ##  ##  ######  ##      ##
##  ##  ##    ##      ##  ##  ##
##  ##  ##  ##  ####      ##  ##
##  ##  ##  ##      ####  ##  ##
##      ##    ####    ##    ####
####  ######      ##    ##    ##
####    ##    ####    ##  ##  ##
##  ##    ##    ##  ##    ##  ##
##      ##    ####    ##  ##  ##
##  ####  ##      ##  ##  ##  ##
##  ####    ####      ##  ##  ##
##        ##    ##  ##    ##  ##
####  ##      ##      ##        
################################
