################################
  ##          ##        ##    ##
##    ######      ####  ####  ##
##  ##    ##  ####  ##    ##  ##
##    ##  ##  ##      ##  ##  ##
####      ##      ##  ##      ##
##  ####    ######    ##  ##  ##
##        ##    ##  ##    ##  ##
####  ##  ##  ##    ##  ##    ##
##    ####    ##  ##  ##    ####
##  ##      ##          ##    ##
##      ##  ##  ######    ##  ##
########      ##      ##  ##  ##
##      ##  ##    ##  ##    ####
##  ##          ##      ##      
################################
