################################
  ####            ##          ##
####    ##  ######    ######  ##
##    ##  ##        ##    ##  ##
##  ##        ##  ####  ##    ##
##      ######    ##    ##  ####
##  ####      ####    ##    ####
##    ##  ##        ######    ##
####  ##  ####  ##    ##  ##  ##
##    ##    ##    ####        ##
##  ##  ##    ##    ##  ####  ##
##      ######  ##  ##    ##  ##
######              ##  ##    ##
##      ##  ########    ####  ##
##  ##    ##          ##        
################################
