################################
  ####        ##    ####      ##
####    ####    ##        ##  ##
##    ##  ##  ##    ######    ##
##  ##      ##    ##      ##  ##
##      ##    ##    ####  ##  ##
##  ##  ##  ##  ##  ##    ##  ##
##    ####      ##    ##      ##
##  ##      ##    ##  ##  ######
####    ####  ##  ##    ##    ##
##    ##  ##        ##  ##  ####
##  ##        ####  ##  ##    ##
##  ##  ######  ######    ##  ##
##    ##              ##  ##  ##
####      ##  ##  ##            
################################
