################################
        ##                    ##
##  ##    ##################  ##
##  ####                      ##
##    ########  ########  ##  ##
####        ####        ##    ##
##    ####    ##  ####  ##  ####
##  ##    ##  ##    ##  ##    ##
##      ##      ##  ##  ########
##  ####    ####    ##        ##
####      ##      ##  ##  ##  ##
##    ####    ####    ##  ##  ##
##  ##  ##  ##  ##  ######    ##
##              ##    ##    ####
##  ##  ##  ##    ##      ####  
################################
