################################
  ##          ##      ##  ##  ##
##    ####  ##    ##          ##
##  ##      ##  ##  ##  ##  ####
##  ####  ##        ##  ##    ##
##    ##      ####    ##  ##  ##
######  ##############        ##
##            ####      ##  ####
##  ####  ##        ##    ##  ##
##      ##  ##  ##  ######    ##
####  ##      ######      ##  ##
##    ##  ##  ######  ##      ##
##  ##    ##    ##      ########
##  ##  ##  ##      ##  ##    ##
##            ##  ##        ##  
################################
