################################
          ##            ##    ##
####  ##    ##  ######      ####
##    ##  ####        ####    ##
####  ##      ##  ##  ##  ##  ##
##    ######    ##    ##  ##  ##
####        ##      ##    ##  ##
##    ####  ##  ####  ##  ##  ##
######      ####          ##  ##
##      ####      ####  ##    ##
##  ####    ##  ##      ##  ####
##  ##  ##  ##  ##  ####    ####
##      ##      ##        ##  ##
##  ##  ########  ####  ##    ##
##  ##            ##        ##  
################################
