################################
  ##      ##              ##  ##
##    ##  ##  ######  ####    ##
##  ##    ##  ##  ##    ####  ##
##    ######  ##  ####        ##
####          ##      ##########
##    ##########  ##          ##
##  ##          ######  ##  ####
##    ####  ##    ##    ##    ##
####  ##    ####      ######  ##
####      ##    ######  ##    ##
##  ######    ##            ####
##          ####  ######  ##  ##
####  ######            ##    ##
##            ####  ##      ##  
################################
