################################
  ##        ##          ##    ##
##    ##  ##    ####  ##    ####
##  ####  ##  ##      ##  ##  ##
##  ##    ##  ##  ######      ##
##  ##  ##    ##        ##  ####
####    ####  ##  ####  ##    ##
##    ##        ##  ##    ##  ##
##  ##    ######      ##      ##
##      ####      ##  ##  ##  ##
########      ##  ######    ####
##        ##    ##      ##    ##
####  ####    ##    ##  ##  ####
##      ######    ####        ##
##  ##          ##      ####    
################################
