################################
  ##        ##              ####
##    ####  ##  ##  ##  ##    ##
##  ##      ##  ##  ##    ##  ##
##    ####  ##  ##    ####    ##
####    ##    ######      ##  ##
##  ##    ##    ##    ##  ##  ##
##  ##  ######  ##  ##    ##  ##
##  ##    ##    ####  ##  ##  ##
##    ##    ##        ##  ######
##  ##    ##  ######  ##      ##
##  ##  ##        ##  ##  ##  ##
##  ##    ##  ##    ##  ##    ##
##  ####  ####  ##  ##      ####
##                      ##      
################################
