################################
  ##        ##              ####
##    ####      ####  ####    ##
##  ##    ######    ##    ##  ##
##    ##        ##  ####      ##
####  ####  ####        ##  ####
##      ##  ##    ####    ##  ##
##  ##  ##  ##  ##      ##    ##
####    ##      ##  ##      ####
##    ##    ####    ##  ##    ##
##  ##  ##      ##    ##  ##  ##
##        ##  ##    ##    ##  ##
####  ##  ####    ##    ##    ##
##  ##        ##    ##  ##  ####
##      ####      ##            
################################
