################################
                ##          ####
##  ##########  ##  ######    ##
##  ##      ##  ##  ##  ####  ##
##    ####  ##      ##        ##
####    ##    ######  ##  ######
######  ##  ##        ##  ##  ##
######  ##  ##  ####  ##  ##  ##
####    ##          ####      ##
##    ####  ##  ##      ####  ##
##  ####      ##  ##  ##  ##  ##
##  ##    ##  ##  ##          ##
##  ##  ####        ####  ######
##    ##    ######      ##    ##
####    ##          ##      ##  
################################
