################################
  ##          ##  ##          ##
##    ####  ##      ######  ####
##  ##          ##            ##
######  ########  ##  ##  ##  ##
##      ##        ##    ##  ####
##  ######  ##  ##  ##  ##    ##
##          ##  ##        ##  ##
##  ##  ####    ##  ##  ####  ##
##    ##  ##  ####    ##      ##
####  ##  ##      ######  ######
##    ##    ####          ##  ##
##  ##    ####  ######  ##    ##
##  ##  ####          ####  ####
##            ##  ##            
################################
