################################
  ##      ##        ##        ##
##    ##  ####  ##      ####  ##
##  ####      ##  ######      ##
####    ####            ####  ##
######      ##  ######    ##  ##
####    ##  ####      ##  ##  ##
##    ####        ##  ##      ##
##  ##    ##  ######    ####  ##
##    ##  ##  ##      ######  ##
####      ##    ####    ##    ##
##  ####    ##      ####    ####
##  ####  ##    ##        ##  ##
##          ####  ##########  ##
##  ##  ##                      
################################
