################################
  ######          ##          ##
######    ####  ##    ####  ####
####    ##      ####  ####    ##
##    ##  ######          ##  ##
####            ##  ####  ##  ##
##  ##  ####  ##      ##  ##  ##
##    ##  ##    ####    ##    ##
##  ##      ##    ######    ####
##  ##  ##    ##          ##  ##
##      ##  ##  ########      ##
##  ######              ####  ##
##  ##      ####  ##  ##      ##
##  ##  ####  ####  ##    ##  ##
##  ##                  ##      
################################
