################################
  ####        ##            ####
####    ######    ####  ##    ##
##    ##        ##      ##  ####
##  ##    ##########  ####    ##
##    ##        ##    ##  ##  ##
####  ######  ##    ##        ##
####      ##  ##  ####  ##  ####
##  ####  ##  ##  ##    ##    ##
##  ##      ##    ####    ##  ##
##  ##  ##  ##  ##    ##    ####
##  ##    ##    ####  ####    ##
##    ##      ##        ####  ##
####    ######    ####        ##
######          ##      ##  ##  
################################
