################################
  ##      ##            ##    ##
##    ##    ####  ####      ####
##  ##  ##    ##  ##  ####    ##
##  ##    ##      ##      ##  ##
##    ##    ####    ####      ##
####    ##      ##  ##    ######
##  ##  ####  ####    ##      ##
##  ##    ##  ##  ##    ####  ##
##  ####  ##        ##    ##  ##
##    ##    ######    ##    ####
####      ##        ##  ##    ##
##    ######  ####  ##    ##  ##
##  ##        ####    ##  ##  ##
##      ##  ##      ##          
################################
