################################
  ##    ##  ##          ####  ##
##    ##        ######        ##
##  ####  ####        ######  ##
##  ##      ########  ##      ##
##    ####        ##  ##  ##  ##
####        ##  ##    ######  ##
######  ##########  ##      ####
####    ##  ##      ##  ##    ##
##    ##    ##  ##  ##    ##  ##
##  ##  ##  ##  ####  ####    ##
##  ##  ##  ##              ####
##  ##        ####  ############
##  ##  ####  ##  ##        ####
##      ##            ####      
################################
