################################
  ##                ##        ##
##    ######  ####    ##  ##  ##
##  ####  ##      ##    ##    ##
##          ####    ##  ##  ####
######  ##      ##  ##  ##    ##
##        ##  ##    ##    ##  ##
##########    ##  ##  ##  ##  ##
##        ##  ##      ##      ##
##  ####  ##    ##  ##  ##  ####
##  ##      ####    ##  ##    ##
##    ####        ##      ##  ##
####  ##  ####  ##  ##  ##    ##
##    ##      ##        ####  ##
##  ##    ##      ####          
################################
