################################
  ######      ##  ##      ######
######    ##          ##    ####
####  ####    ####  ######    ##
##    ##    ##        ##    ####
##  ##  ####  ######    ##    ##
##                ####    ##  ##
######  ##  ####    ##  ####  ##
##    ##  ##    ##  ##      ####
####        ##  ##  ##  ##    ##
##    ####      ##    ######  ##
####      ######  ##    ##    ##
##    ##          ####  ##  ####
####  ######  ####      ##    ##
##        ##        ##      ##  
################################
