################################
  ####              ##      ####
####    ####  ####      ##    ##
##    ##      ##  ##  ##    ####
####    ####        ####  ##  ##
##  ##    ##  ####  ##        ##
##    ##    ##        ##  ##  ##
##  ##    ##    ##  ##      ####
##  ##  ##  ##  ####    ##    ##
##      ##  ##      ####  ##  ##
##  ####      ####        ##  ##
##  ##  ####      ####  ##    ##
##  ##        ####  ##    ##  ##
##  ####  ##  ##      ##  ##  ##
##        ##      ##    ##      
################################
