################################
  ##              ##          ##
##    ####  ####    ####  ##  ##
##  ######      ####    ##    ##
##    ##  ####      ##      ####
####      ##    ##    ####    ##
##  ####  ##  ##  ##    ####  ##
##    ##  ##  ##  ####    ##  ##
####      ##          ######  ##
##    ####  ########          ##
##  ##      ##      ####  ######
##  ##  ##      ##      ##    ##
##  ####    ####    ##    ##  ##
##      ####  ##  ####  ####  ##
##  ##            ##            
################################
