################################
  ##    ####          ##      ##
##    ##      ##  ##    ##  ####
##  ##    ######    ##  ##    ##
##      ##      ##  ##      ####
##  ##      ####    ######  ####
##    ##  ##      ##          ##
####    ####  ####  ##  ####  ##
##  ####      ##    ##  ##  ####
##        ####  ##  ##  ##    ##
####  ####              ####  ##
##        ##  ##########      ##
##  ##  ##    ##        ####  ##
##    ##    ####  ####  ####  ##
####    ##        ##            
################################
