################################
          ##  ##      ##  ##  ##
##  ####  ##      ##  ##      ##
##  ##    ##  ####    ##  ##  ##
####    ##      ##  ##    ##  ##
##    ##    ##  ##    ####    ##
####    ######    ##        ####
##  ##        ##  ####  ##    ##
##    ######  ##      ##  ##  ##
####      ##  ##  ##      ##  ##
##    ##  ##    ##    ##  ##  ##
##  ##      ##  ##  ##    ##  ##
##  ##  ######  ####    ####  ##
##  ##                ####    ##
##    ##  ##  ####  ##      ##  
################################
