################################
  ####            ##  ##    ####
####    ########        ##    ##
##    ####        ####    ##  ##
##  ####    ######    ##      ##
####      ##      ##    ####  ##
##    ####    ##      ##      ##
##  ####    ######  ##    ######
##      ##    ########  ##    ##
######    ##    ##      ####  ##
##  ##  ##  ##      ####      ##
##  ##  ##  ##  ##  ##  ####  ##
##    ##          ##          ##
##  ####  ########    ######  ##
##                  ##          
################################
