################################
  ##                ####      ##
##    ##  ####  ##        ##  ##
##  ####    ######  ####  ##  ##
##  ##  ##        ##    ##    ##
##        ##  ##    ##      ####
##  ####    ######    ##  ##  ##
##    ####    ######  ##  ##  ##
####    ####    ##    ##  ##  ##
##  ##    ##  ####  ##    ##  ##
##    ##    ##      ##  ##    ##
####      ##    ####    ##  ####
####  ####    ##      ##      ##
##      ##  ##  ####  ######  ##
##  ##    ##                    
################################
