################################
  ##      ##    ##      ########
##    ##      ##    ##    ######
######    ####    ##  ##    ####
##      ##      ##      ##    ##
##  ##  ##  ####    ####  ##  ##
##  ####    ##    ##          ##
##    ##  ##    ##    ##########
####  ##    ##    ##  ##      ##
##      ##    ##      ######  ##
##  ##    ####  ####          ##
####    ####        ####  ##  ##
##    ##      ####      ##    ##
##  ####  ######  ####      ####
##                    ##  ####  
################################
