################################
  ##        ####  ##          ##
##    ####            ######  ##
##  ##  ##  ##  ##  ##    ##  ##
##        ##      ##    ####  ##
##  ####    ##  ##    ####    ##
##  ##    ##    ##  ##      ####
####    ##    ##      ####    ##
##    ######  ##  ##  ##    ####
##  ##  ##      ##    ##  ##  ##
##  ##      ##  ##  ##    ##  ##
##    ##  ######    ##  ####  ##
##  ##      ##    ##          ##
##    ########  ##    ######  ##
####            ##  ##          
################################
