################################
  ##  ##      ##    ##        ##
##    ##  ##  ####      ####  ##
##  ##    ##    ####  ######  ##
##    ##  ####    ##    ##    ##
##  ####      ##  ####  ##  ####
##      ####  ####      ##  ####
####  ##  ##    ######  ##    ##
##          ##      ##  ####  ##
##  ####  ##  ####  ##      ####
##    ##  ##    ##  ##  ##    ##
####  ##      ##    ######  ####
##    ########    ##        ####
##  ##          ##    ####    ##
##      ##  ##      ########    
################################
