################################
            ##    ##      ##  ##
##  ######    ##      ##  ##  ##
##        ##  ##  ####    ##  ##
##  ####    ####    ######    ##
##  ##  ##      ##      ##  ####
##  ##  ######    ##  ##      ##
##  ##        ##  ##      ##  ##
##    ##  ##  ##    ######    ##
##  ##      ######  ##  ##  ####
##  ######    ####      ##  ####
##      ####      ####  ##    ##
######    ##  ##    ##    ##  ##
##    ##  ######  ##    ##    ##
####                ##      ##  
################################
