################################
                  ##          ##
##  ####  ##  ##    ##  ####  ##
##    ##    ######      ##    ##
####  ####    ######  ##    ####
##  ##    ##    ##  ##    ######
##    ##    ##  ##  ##  ##  ####
##  ##  ##      ##      ##    ##
##  ##    ##  ##    ####  ##  ##
##      ##  ##  ##    ##      ##
##  ##            ##    ##  ####
##    ####  ##  ##    ##      ##
####      ##      ##  ##  ##  ##
##  ##  ##    ######  ####    ##
##        ##                ##  
################################
