################################
  ##              ##          ##
##    ######  ##      ##  ##  ##
##  ##      ########    ##    ##
##  ##  ##    ##      ##    ####
##      ##  ##    ####    ##  ##
########      ##    ####      ##
##      ####    ##      ####  ##
##  ##      ##    ####      ####
##    ####  ####      ####    ##
####    ##      ####      ##  ##
########  ####    ########    ##
####        ####            ####
##    ####      ######  ##    ##
##  ##      ##            ##    
################################
