################################
  ####      ##          ##    ##
####    ##    ####  ##      ####
##    ########        ####    ##
##  ######      ####  ##  ##  ##
##    ##    ####    ##        ##
####      ####    ##    ########
######  ##      ##    ##      ##
####    ##  ##  ##  ##  ##  ####
##    ##      ##  ##          ##
####    ####      ######  ##  ##
##  ##  ##    ##        ####  ##
##  ##  ####    ##  ##        ##
##            ##  ##  ####  ####
##  ##  ##  ##                  
################################
