################################
    ##      ##    ##    ##    ##
##      ##    ##      ##    ####
##  ##    ####  ##  ##    ##  ##
##  ##  ##      ##  ##  ##    ##
##    ##    ##      ##      ####
####  ##  ##  ########  ##    ##
##        ##              ##  ##
##  ##  ##    ####  ######    ##
##  ##  ##  ##    ####      ####
##    ##        ##      ##    ##
####    ####  ##    ####  ##  ##
##  ##      ##    ##      ##  ##
##  ##  ##    ##  ##  ####    ##
##        ##      ##        ##  
################################
