################################
            ##      ##  ##    ##
##  ######    ####          ####
##  ##    ##      ######  ######
##    ##    ####            ####
####    ##    ########  ##    ##
######    ##          ##    ####
########  ####  ####    ##    ##
########      ########  ##  ####
######    ##  ######    ##    ##
####  ##  ##    ##    ##  ##  ##
##    ##    ##  ##  ##    ##  ##
##  ########    ##      ##    ##
##  ####      ##    ####    ####
##        ##    ##        ####  
################################
