################################
  ##  ##  ##                  ##
##          ##  ##  ##  ########
##  ######    ####  ##        ##
##        ##      ##    ####  ##
########  ##  ##  ##  ##  ##  ##
##    ##    ##    ####        ##
##  ##  ##    ##        ####  ##
##  ##    ##    ######    ##  ##
##      ##  ##  ##      ##    ##
####  ####      ##  ####    ####
##    ##    ##  ##  ##    ######
####    ##  ##    ##    ########
######    ##  ####    ##########
########            ##########  
################################
