################################
  ##              ##      ##  ##
##    ##  ####  ##    ##      ##
##  ##    ##  ####  ##  ##  ####
######  ##              ##    ##
##      ##  ########  ##  ##  ##
##  ######  ##      ##        ##
##          ##  ##  ##  ########
##  ########  ####      ##    ##
##  ##    ##      ######  ##  ##
##    ##      ##      ##      ##
####    ##  ##    ##    ####  ##
######  ##  ##  ##  ##    ##  ##
####      ##    ##  ####  ##  ##
##    ##      ##                
################################
