################################
  ##  ##              ####    ##
##    ####  ##  ####      ##  ##
##  ##  ##    ##    ####  ##  ##
##        ##    ##  ##        ##
####  ##  ##  ##        ####  ##
##  ##    ##    ##  ####  ######
##  ##  ######  ##  ##        ##
##  ##    ##    ####    ####  ##
##    ##    ##        ##      ##
##  ##  ##    ######  ##  ##  ##
##        ##        ##      ####
##  ####    ##  ##  ######    ##
##  ##  ####  ####      ####  ##
##                  ##          
################################
