################################
  ##      ##            ##    ##
##    ##      ####  ##      ####
######  ##  ##    ##  ####    ##
##        ######        ####  ##
####  ##    ####  ####        ##
####  ##  ##      ##############
##    ##  ##  ####  ##        ##
##  ##    ##  ##        ####  ##
##  ##  ##    ####  ####  ##  ##
##  ##  ##  ##      ##        ##
##  ##  ##  ##  ##  ##  ##  ####
##    ####  ####  ##    ##    ##
##  ##            ##  ####  ####
##      ####  ##      ##        
################################
