################################
    ##  ##  ##        ##  ##  ##
##            ##  ##          ##
####  ##  ##    ##    ##  ##  ##
##    ##    ##    ####    ##  ##
##  ##  ##  ####      ##  ##  ##
##      ##      ####  ####    ##
######    ####  ##          ####
##    ##  ##    ##########    ##
##  ####    ##          ####  ##
##      ##    ########    ##  ##
##  ##      ##        ##  ##  ##
##  ########    ##  ##    ##  ##
##        ######    ##  ##    ##
####  ##          ##    ##  ##  
################################
