################################
  ##            ##            ##
##    ####  ####    ########  ##
##  ##          ####      ##  ##
##    ####  ##        ##      ##
####      ##  ##  ####  ####  ##
##    ##        ##            ##
####    ######  ##  ############
##    ##        ####          ##
##  ##    ##  ##      ##  ##  ##
##    ##    ##    ####  ##    ##
##  ##  ##      ####        ####
####      ######      ####    ##
##    ##  ##      ####  ####  ##
##  ##        ####              
################################
