################################
    ##      ##  ##            ##
##      ##          ##  ####  ##
##########  ####  ##      ##  ##
##        ##        ##  ##  ####
##  ####    ######    ####    ##
##      ##      ####      ##  ##
####  ##  ####      ##  ####  ##
##    ##      ##  ##    ##    ##
##  ##  ####          ####  ####
##  ##      ##  ##  ##      ####
##  ##  ##  ####  ####  ####  ##
##      ##              ##    ##
##  ####  ##############    ####
##                        ####  
################################
