################################
  ##            ##        ##  ##
##    ######  ##    ##  ##    ##
##  ####      ##  ####  ##  ####
##      ##  ##        ####    ##
######  ##  ########      ##  ##
##      ##        ##  ##  ##  ##
##  ####  ######      ####    ##
##  ##        ##  ##    ##  ####
##    ##  ##        ####    ####
##  ##      ##  ####      ##  ##
##  ##  ##    ####    ######  ##
##  ##    ####      ##        ##
##  ######      ######  ####  ##
##          ##          ##      
################################
