################################
  ##            ##  ##  ##    ##
##    ##  ####            ##  ##
##  ####    ######  ####      ##
##  ##  ##      ####      ##  ##
##        ####      ##  ##    ##
########  ##  ####    ##    ####
##      ##      ####    ####  ##
##  ##      ##    ##  ##      ##
##    ##########      ##  ##  ##
##  ##      ##    ####    ##  ##
##      ##    ####      ####  ##
##  ####  ##  ##    ####      ##
##  ##    ##      ####    ##  ##
##      ##    ####      ##      
################################
