################################
      ##      ####  ##  ##    ##
##  ##    ####              ####
##      ##    ##  ####  ##    ##
##  ####    ##      ##    ##  ##
##  ##  ##      ##    ####  ####
##  ##      ##  ####          ##
##    ##  ####    ######  ##  ##
####    ##      ##      ##    ##
##  ##  ##  ####    ##    ##  ##
##  ##    ####    ##    ##    ##
##    ##  ##    ##  ##  ##  ####
##  ####      ####      ##    ##
##      ######      ####    ####
##  ##          ##        ####  
################################
