################################
            ##    ####        ##
####  ####    ##        ##  ####
####      ####    ######      ##
##    ##      ##      ##  ##  ##
######  ####    ##  ##    ##  ##
##          ##  ##    ##  ##  ##
##  ##  ##      ##  ##  ##  ####
##    ##  ####  ##  ##        ##
####          ##    ##  ####  ##
##    ####  ##    ##  ##  ##  ##
######      ##  ##            ##
##      ##  ##    ####  ####  ##
##  ####  ##  ##  ##    ##    ##
##                    ##    ##  
################################
