################################
  ##      ##        ##        ##
##    ##  ##  ##  ##    ####  ##
##  ##        ##    ####      ##
##  ##  ####    ##      ####  ##
##    ##    ##  ##  ##        ##
####    ##    ##      ##  ######
######      ##    ##    ##    ##
####    ##  ##  ##  ##    ##  ##
##    ##    ####        ##    ##
##  ######      ####  ##    ####
##    ##  ####      ####  ##  ##
####  ##  ##  ####        ##  ##
##            ##  ##########  ##
##  ####  ##                    
################################
