################################
  ##      ##      ##    ##    ##
##    ##  ##  ##  ####      ####
##  ##    ##  ##      ####  ####
##  ####  ##    ####    ##    ##
##    ##    ##      ##  ####  ##
####    ##    ####  ##        ##
##  ##    ##  ##      ##  ##  ##
##      ##  ##    ##  ####  ####
##  ####      ##  ##          ##
##        ##  ##    ##  ####  ##
########  ##    ######    ##  ##
##      ##    ##      ####    ##
##  ######  ####  ##        ####
##                  ##  ##      
################################
