################################
  ####      ##            ##  ##
####    ##    ##  ######      ##
##    ##  ##    ##      ####  ##
##  ##      ##      ##    ##  ##
##  ##  ####  ####    ##      ##
##  ##            ##  ##  ######
##  ##  ##  ####  ##    ##    ##
##    ##    ##      ##      ####
####  ##  ##  ####    ######  ##
####      ##        ##        ##
##  ####  ##  ##  ##    ####  ##
##      ##    ####    ##  ##  ##
##  ##  ##  ##      ##        ##
##  ##          ####    ##  ##  
################################
