################################
        ##  ##            ######
######          ########    ####
##    ##########        ##    ##
####          ##  ##  ##    ####
##    ####  ##    ##    ##    ##
####  ##    ##  ##    ##  ##  ##
##      ##      ####      ##  ##
##  ##    ##  ##      ##  ##  ##
##  ####    ##    ##  ####    ##
##      ##  ##  ####    ##  ####
####  ######    ##    ##    ####
##      ##    ##  ####    ##  ##
####  ##    ##      ##  ##    ##
##      ##      ##          ##  
################################
