################################
  ##                      ##  ##
##    ##  ##  ##  ##  ####    ##
##  ##    ##  ##  ##        ####
##    ##  ##    ##  ######    ##
####    ##  ##  ##  ##  ##  ####
##  ####        ##            ##
##        ######  ##########  ##
####  ####                ##  ##
##    ##    ######  ####  ##  ##
##  ####  ##      ##        ####
##        ####  ##  ##  ##    ##
##  ##  ##      ##    ####  ####
####      ##  ##    ##      ####
##    ##        ##      ##      
################################
