################################
                      ##  ##  ##
####  ##  ########  ##        ##
##      ##      ##      ####  ##
##  ##  ##  ##  ########      ##
##  ##  ##  ##        ##  ######
##  ##  ##    ######  ##      ##
##    ##    ##    ##    ####  ##
####  ##  ####  ##    ##  ##  ##
##    ##          ##  ##  ##  ##
##  ##  ##  ##  ##    ##  ##  ##
##      ##    ##    ##    ##  ##
##  ##  ####  ##  ##    ####  ##
##  ##        ##  ####        ##
##    ##  ##  ##    ##  ##  ##  
################################
