################################
            ##                ##
##  ##  ##      ##  ####  ##  ##
##  ##  ######    ##      ##  ##
##    ##      ####    ####    ##
######    ##    ##  ##  ####  ##
##      ##    ##    ##        ##
##  ##  ##  ##    ##  ##  ######
##    ##        ####  ##      ##
####  ##  ######      ######  ##
##    ##  ##      ####        ##
####    ##    ####    ##  ######
##  ##  ##  ##    ##      ##  ##
##      ##  ##  ####  ####    ##
##  ##      ##              ##  
################################
