################################
                ####      ######
##  ##  ####  ##      ##    ####
####      ##  ##  ####  ##    ##
##    ##  ##  ##          ##  ##
####    ##    ########  ##    ##
##  ##    ##          ##    ####
##    ##    ##  ####      ##  ##
##  ##  ##    ##    ########  ##
##        ##    ##            ##
####  ##    ##    ##  ######  ##
##    ####    ##      ##      ##
##  ##    ##    ##  ##    ######
##  ##  ##  ##    ####  ##    ##
##            ##            ##  
################################
