################################
    ##          ##        ##  ##
##    ##  ####    ##  ##      ##
####      ##  ##      ####  ####
##  ##  ##      ######  ##    ##
##      ##  ##  ##      ##  ####
##  ##      ##    ##  ####    ##
##    ######    ####      ##  ##
##  ##      ##  ##    ##  ##  ##
####    ##  ##    ##  ##      ##
##    ##    ####    ##  ####  ##
######    ##    ##  ##      ####
##      ##  ##          ##    ##
####  ##      ##########    ####
##        ##              ####  
################################
