################################
            ##  ##    ##      ##
##  ##  ##      ##  ##    ##  ##
####      ##  ##    ##  ##    ##
####  ##    ##    ##    ##  ####
##    ##  ##    ######  ####  ##
##  ##      ##    ##          ##
##  ##  ##  ####    ########  ##
##    ##      ####            ##
####    ####    ##  ######  ####
######      ##    ##    ##    ##
####    ##    ##      ######  ##
##    ##  ##    ######  ##    ##
##  ##    ##  ##            ####
##      ##        ##  ##  ####  
################################
