################################
  ##            ##            ##
##    ##  ####      ########  ##
##  ##    ##  ######      ##  ##
##    ##  ##          ##      ##
##  ####    ####  ####  ########
####    ##  ##    ##          ##
##    ##    ##  ##    ##  ##  ##
##  ##    ##      ##    ##    ##
##    ##    ####    ##    ##  ##
####    ##  ##    ##  ##    ####
##    ##    ##  ##      ##    ##
##  ####  ##    ####  ##  ##  ##
##        ##  ##  ##          ##
##  ##  ##            ##  ##    
################################
