################################
  ##            ####          ##
##    ##  ##  ##      ##  ##  ##
##  ##      ##    ######    ####
##    ########  ##      ##    ##
####            ##  ####    ####
##    ########  ##    ##  ##  ##
####          ##    ####      ##
##  ########      ##      ##  ##
##          ####  ####  ##    ##
##  ####  ##  ##    ##    ##  ##
##    ##        ##    ##  ##  ##
####  ####  ##    ##  ##    ####
##      ##    ######    ##    ##
##  ##    ##          ##    ##  
################################
