################################
          ##          ##  ######
##  ####      ##  ##  ##    ####
##    ##  ####  ##    ####    ##
##  ##    ##      ##      ##  ##
####    ####  ##    ####  ##  ##
##    ##      ##  ##      ##  ##
##  ######  ######    ####    ##
##  ####    ####    ##      ####
##        ##      ##    ##  ####
##  ######  ##  ##    ##      ##
####        ##  ##  ####  ##  ##
##    ####  ##  ##      ####  ##
##  ##  ####      ####  ##    ##
##            ##        ##  ##  
################################
