################################
    ##                ##  ##  ##
##      ##  ####  ####    ##  ##
##  ##    ##  ##        ####  ##
####    ##      ##  ####      ##
##    ##    ##    ##      ##  ##
##  ##    ##    ##    ##  ##  ##
##    ##  ######    ######    ##
####  ##          ##  ##    ####
####    ####  ####      ########
##  ##    ##        ##      ####
##  ####    ##  ##    ####    ##
##        ##    ######    ##  ##
##  ######  ####        ##    ##
##                ####      ##  
################################
