################################
  ##          ##      ##      ##
##    ##  ##  ##  ##    ####  ##
##  ##  ##    ##    ##    ##  ##
##      ##  ##    ##  ####    ##
######  ##  ##  ####        ####
##      ##  ##        ####    ##
####  ##      ########    ##  ##
##    ##  ##        ####      ##
##  ####    ####  ##      ######
##      ##  ##    ##  ####    ##
##  ##  ##  ##  ##          ####
##  ##  ##  ##    ########    ##
####    ##  ######        ##  ##
##    ##            ####        
################################
