################################
        ##                ##  ##
##  ####    ##  ########      ##
##    ##  ####          ########
##  ####      ########        ##
##      ##  ##        ##  ##  ##
##  ##      ##  ####  ##  ##  ##
##  ##  ####    ##      ##    ##
##    ##      ##########    ####
##  ##    ##    ##      ##  ####
##  ##  ####  ##    ##  ##    ##
##    ##      ##  ####    ##  ##
####  ##  ##  ##  ##    ##    ##
####  ##  ##  ##    ####    ####
##        ##    ##        ####  
################################
