################################
        ##    ##        ##    ##
##  ##      ####  ####    ##  ##
##  ####  ##      ##  ##      ##
##    ##      ######    ####  ##
####    ##  ####      ##      ##
##  ##    ####    ##  ##  ##  ##
##    ##        ##    ##    ####
####    ####  ##  ##    ##    ##
##  ##      ##    ####  ####  ##
##  ##  ##    ##          ##  ##
##    ##    ##  ######  ##    ##
####      ##          ##    ####
####  ####    ##  ##    ##    ##
##          ##      ##      ##  
################################
