################################
  ##      ##  ####        ##  ##
##    ##            ####      ##
##  ##  ##  ####  ##    ####  ##
##        ##  ##    ##    ##  ##
########  ##    ##    ##      ##
##    ##  ##  ######  ##########
####            ##            ##
##    ########    ####  ####  ##
##  ##        ##      ##  ##  ##
######  ####    ####      ##  ##
##      ##  ##      ########  ##
##  ####      ##  ##          ##
##        ##  ##      ####  ####
##  ##  ##      ##  ##          
################################
