################################
  ##        ##    ##          ##
##    ####      ##    ######  ##
##  ##    ####    ####        ##
##    ##      ##  ##    ####  ##
####      ##  ##    ##      ####
##    ##  ##    ##  ##  ##    ##
##  ##    ####  ##  ##    ##  ##
##  ######      ##  ##  ##    ##
####        ####    ######  ####
##  ####  ##    ##            ##
##  ##  ##    ##  ####  ##  ####
##          ####      ####    ##
##  ####  ####    ##      ##  ##
##    ##        ##    ##        
################################
