################################
  ##      ##      ####  ##    ##
##    ##      ##          ##  ##
##  ##  ############  ##      ##
##            ##  ##    ##  ####
####  ######  ##    ##  ##    ##
##  ##    ##    ##  ##    ##  ##
##      ##  ##        ##    ####
####  ##      ##  ##    ####  ##
####      ####  ######        ##
##    ##          ##    ####  ##
##  ############    ####  ##  ##
##    ##        ##        ##  ##
####  ##  ##  ##  ####  ##    ##
##        ##        ##      ##  
################################
