################################
                    ##        ##
##  ####  ########    ##  ##  ##
##      ##        ##    ####  ##
##  ##      ####    ##        ##
##    ######      ##  ######  ##
########      ######          ##
##        ######      ######  ##
##  ########      ####      ####
##          ##  ####    ##    ##
##  ######    ##    ####  ##  ##
##  ##    ##      ####    ##  ##
##      ##  ####        ##    ##
##  ####      ######  ##    ####
##        ##      ##      ####  
################################
