################################
  ####                ##      ##
####    ##  ########      ##  ##
##    ##  ##        ######    ##
##  ##    ##  ####      ########
##    ##        ######        ##
##  ##    ##  ##      ######  ##
##  ##  ##  ##    ####        ##
##  ##  ##  ##  ##  ##  ####  ##
##  ##      ##  ##  ##      ####
##    ##  ####  ##  ######    ##
##  ####        ##        ##  ##
##      ##  ####    ##  ##    ##
####  ##  ##  ##  ####    ##  ##
##                    ##        
################################
