################################
    ##          ##            ##
##  ##  ##  ##    ##  ######  ##
##      ##  ####  ##  ##      ##
##  ######      ##    ##  ##  ##
##  ##    ####      ##    ##  ##
##    ##      ##  ####  ####  ##
####      ##    ##      ##    ##
##  ######    ####  ##    ##  ##
##        ####      ######    ##
####  ##    ##  ####      ##  ##
##  ######  ##        ##  ##  ##
##    ##    ##########    ##  ##
####      ##        ##  ##    ##
##    ##      ####      ##  ##  
################################
