################################
  ##        ####        ##    ##
##    ####        ####  ##  ####
##  ####  ##  ####      ##    ##
####      ##  ##  ##  ######  ##
####  ##      ##        ##    ##
##    ########    ####    ##  ##
##  ##      ####  ##  ##      ##
##  ######              ########
##      ############  ##      ##
##  ##            ######  ##  ##
##  ####  ######          ##  ##
##      ##      ####  ####    ##
##  ##    ##  ##    ##      ####
##    ##          ##    ##      
################################
