################################
  ##      ##                  ##
##    ##  ##  ####  ##  ####  ##
##  ##  ##    ####    ##  ##  ##
##      ##  ##    ##  ##  ##  ##
##  ##          ##    ##  ##  ##
####  ########  ##  ##        ##
##          ##  ##  ########  ##
##  ##  ##    ####          ####
##    ##  ##      ########    ##
####      ######  ##      ##  ##
##  ######    ##  ##  ##  ##  ##
##        ##      ##  ##  ##  ##
##  ######    ##  ##  ##  ##  ##
##          ##        ##        
################################
