################################
  ##  ##    ##  ##            ##
##        ##        ##  ####  ##
##  ##  ####  ########      ####
##  ####      ##        ####  ##
##    ##  ######  ####  ##    ##
####      ##      ##  ##    ####
##    ######  ####        ######
########      ##    ######  ####
##        ####    ####        ##
##  ####    ##  ####    ####  ##
##    ##  ##        ##    ##  ##
####    ##    ####    ##  ##  ##
##    ##    ########    ####  ##
####      ############          
################################
