################################
        ##      ##        ##  ##
##  ##      ##      ##  ##    ##
##    ##  ######  ##    ##  ####
##  ##      ##      ##  ##    ##
##    ####    ##  ##    ##  ####
####    ######    ####  ##    ##
##    ##        ##        ##  ##
##  ##    ##  ##  ##  ##      ##
##    ##    ##          ####  ##
####    ##  ##  ########  ##  ##
##    ##    ##  ##        ##  ##
##  ##    ######    ####  ##  ##
##    ##  ####    ##    ##    ##
####  ##        ######      ##  
################################
