################################
  ##    ##    ##      ####    ##
##  ##      ##    ##      ##  ##
##  ######      ##  ####      ##
##        ##  ##    ##  ##  ####
##  ##  ##      ##      ##    ##
####    ##  ##  ##  ##  ####  ##
##    ##  ##    ######    ##  ##
##  ##        ##      ##      ##
##  ##  ##  ##    ##  ##  ######
##  ##  ##      ##    ##      ##
##  ####    ####  ##  ######  ##
##      ##        ##        ####
##  ##    ########  ######    ##
##    ##                    ##  
################################
