################################
      ######  ##              ##
####    ##      ####  ######  ##
######      ##        ##      ##
####  ##  ##    ##  ##    ##  ##
##        ##  ##  ####  ##    ##
##  ####  ######      ##    ####
##    ####        ##    ##  ####
####    ##  ##  ######  ##    ##
##  ##        ##  ##      ##  ##
##      ######      ####  ######
########        ##    ##      ##
##        ######  ##  ##  ##  ##
##  ########      ##    ##    ##
##            ##    ##      ##  
################################
