################################
  ##      ######            ####
##    ##    ##    ####  ##    ##
##  ######      ##      ####  ##
##    ##  ####    ####    ##  ##
##  ##        ##    ####    ####
####    ####  ####      ##    ##
##    ##  ##      ####    ##  ##
####      ##  ##  ##    ##    ##
##  ######  ##    ##  ####  ####
##      ##  ##  ##  ####      ##
##  ##      ##  ##        ##  ##
##    ######        ##  ##    ##
####        ########  ##  ##  ##
##    ####                      
################################
