################################
  ####          ##            ##
####    ####  ##    ####  ######
##    ##  ##    ####  ##      ##
##  ##      ##          ####  ##
##  ##  ####  ##  ####  ##    ##
##  ##          ##  ##      ####
##    ##  ##  ##      ####    ##
####    ####      ##    ##  ####
##  ##  ##    ####    ####    ##
##  ##    ####      ##    ##  ##
##    ##    ##  ##    ##      ##
##  ##  ##  ##    ######  ######
##  ##  ##  ##  ##            ##
##          ##      ##  ####    
################################
