################################
        ##  ##          ##    ##
####  ##    ##  ##  ##    ##  ##
##      ##  ##    ##  ##  ##  ##
##  ##  ##    ##  ##      ##  ##
##    ##  ##  ##  ######      ##
####      ##  ##        ####  ##
##  ##  ##      ##  ##  ##    ##
##      ##  ####    ##  ####  ##
##  ####        ####        ####
##      ##  ##      ##  ##    ##
##  ##    ########  ##    ##  ##
##    ##    ##      ####  ##  ##
####  ####      ##      ##    ##
##        ##  ##    ##      ##  
################################
