################################
    ##            ##        ####
##      ####  ####    ####    ##
##  ####          ####    ##  ##
##  ##    ######      ##      ##
##    ####      ####      ##  ##
####        ##      ######    ##
##    ######  ##  ##    ##  ####
####      ##  ##    ##  ##    ##
##    ##        ##  ##    ##  ##
##  ##############    ##      ##
##    ##          ##    ####  ##
##  ##    ##  ##  ####      ####
####    ##  ####      ####    ##
##    ##          ##        ##  
################################
