################################
      ##          ##          ##
####      ##  ##    ##  ####  ##
##  ##  ######    ##      ##  ##
##  ##    ##    ####  ##  ##  ##
##      ##    ##      ##  ##  ##
##  ####  ##    ##  ##    ##  ##
##  ##        ##    ##  ####  ##
##  ##  ######    ####      ####
##  ##  ##      ##    ####    ##
##    ##    ####  ##  ##    ####
####  ####    ##      ##  ##  ##
##        ##    ####  ##      ##
####  ##    ##  ##      ####  ##
##      ##          ##      ##  
################################
