################################
      ##  ##      ##      ##  ##
####          ##      ####    ##
##  ##  ##  ##  ##  ####    ####
##    ####      ##        ######
####  ##  ####    ##  ##########
##    ##    ##  ####      ######
##  ##    ####      ####    ####
##    ##      ####  ##  ##    ##
##  ##    ##  ####      ####  ##
##  ########        ##    ##  ##
##          ##  ####  ##  ##  ##
####  ####    ##        ####  ##
##  ##  ####  ##  ####  ##    ##
##                ##        ##  
################################
