################################
                  ##      ##  ##
##  ############  ##  ##  ##  ##
##  ##          ##    ####    ##
##  ##  ######  ####      ##  ##
##  ##  ##  ##      ####      ##
##      ##    ####    ##  ##  ##
##  ####    ##    ##    ##    ##
##    ##  ##  ##    ##      ####
####  ##  ##    ##    ######  ##
##    ##    ##      ##        ##
####  ####      ##  ##  ####  ##
##      ##  ##  ##  ##    ##  ##
##  ##    ####  ##  ##  ##    ##
##    ##        ##      ##  ##  
################################
