################################
  ##        ##        ##      ##
##    ####    ##  ##    ##  ####
##  ####    ##    ####  ##    ##
##      ####    ##  ##  ##  ####
##  ##      ####    ##  ##    ##
##    ####      ##      ####  ##
####    ##  ##      ####      ##
##  ##    ##  ######      ##  ##
##    ##  ##  ##      ####    ##
##  ####          ####  ####  ##
##  ##  ##########  ##        ##
##      ##          ##  ##  ####
####  ##    ##  ######  ####  ##
##        ##                    
################################
