################################
  ####          ####    ##    ##
####    ##  ##      ##      ####
##    ##      ####    ##  ######
##  ##    ####    ##      ######
##    ##  ##  ##      ##    ####
####  ##  ##  ##  ##    ##    ##
##    ####      ##  ##  ####  ##
####      ####  ##  ##    ##  ##
##    ##    ##        ####    ##
####  ####  ##  ####      ##  ##
##      ##    ##  ######    ####
##  ##    ##            ##    ##
##  ####    ########  ##  ##  ##
##      ##        ##            
################################
