################################
                ####  ##      ##
##  ##  ##  ##          ##  ####
####    ##    ####  ##  ##  ####
##    ####  ##    ##    ##    ##
##  ##        ##    ##  ####  ##
##    ##  ##    ##  ##    ##  ##
####  ##  ##  ##      ##  ##  ##
##  ####    ##    ##  ##  ##  ##
##        ##    ##    ##  ##  ##
##  ##  ##    ##  ##  ##  ##  ##
##  ##    ##        ####      ##
##  ####    ##  ##  ##  ####  ##
##      ####    ##      ##    ##
##  ##      ##    ####      ##  
################################
