################################
    ##      ##    ##          ##
##      ##    ##      ######  ##
##  ####  ##    ######        ##
##          ##          ####  ##
##########  ####  ##  ##      ##
##      ####    ##  ##    ######
##  ##      ##      ##  ####  ##
##  ########    ##  ##  ##    ##
##            ##    ##      ####
##  ####  ####  ####  ####    ##
##  ####                  ##  ##
##      ############  ##  ##  ##
####  ##          ##  ####    ##
##        ##  ##  ##        ##  
################################
