################################
        ######      ##        ##
##  ##    ##    ##      ####  ##
##    ##      ##  ##  ######  ##
####  ##  ####          ##    ##
####  ##    ##  ##  ####  ##  ##
##    ####    ##      ##  ######
##  ##    ##    ####  ##      ##
##      ######  ##      ####  ##
######  ######    ##  ##      ##
##  ##    ##  ##  ##  ##  ######
##  ####  ##  ##    ##        ##
##        ##    ##    ##  ##  ##
####  ####    ######    ##    ##
##          ##########      ##  
################################
