################################
  ##    ##              ##    ##
##    ##    ####  ####      ####
##  ##    ##      ##  ##  ######
##      ####  ####          ####
##  ####      ##  ########    ##
##  ##    ####            ##  ##
##    ##        ########  ##  ##
####  ####  ####      ##    ####
####      ##      ####  ##    ##
##    ####    ####        ##  ##
##  ##      ##      ####      ##
##  ##  ##  ####  ##  ######  ##
##      ##    ##            ####
##  ##    ##    ##  ##  ##      
################################
