################################
  ##      ##      ##          ##
##    ##      ##    ##  ####  ##
######    ########    ####    ##
##      ##    ##    ##    ##  ##
##  ####    ##    ##    ##    ##
##      ##      ##  ##      ####
####  ##    ####      ####  ####
##    ####  ##    ##    ##    ##
##  ##      ##  ######      ####
##    ##  ##    ####  ##  ##  ##
####    ##    ##      ####    ##
##  ##      ##    ##        ####
##  ##  ####    ##  ##  ##    ##
##            ##          ##    
################################
