################################
  ####          ##      ##    ##
####    ##  ####    ##  ####  ##
##    ##      ##  ##  ##      ##
####  ##  ##  ##          ##  ##
##      ####    ##########    ##
##  ##      ##            ##  ##
##  ####  ##  ##  ##  ##  ##  ##
##    ####      ##      ##    ##
##  ##      ##      ######  ####
##  ##  ######  ####          ##
##  ##        ##      ######  ##
##    ######      ####      ####
####  ##    ##  ####    ##    ##
##        ##          ######    
################################
