################################
  ##      ##          ##      ##
##    ##    ##  ####    ####  ##
##  ##    ##      ##  ##      ##
##    ####    ####    ##  ##  ##
####    ##  ##  ##  ##    ##  ##
##    ##        ##  ##  ##    ##
##  ##    ##  ##    ##  ##  ####
##      ##  ####  ####  ##    ##
##  ####          ##    ##  ####
##    ##  ########    ####    ##
##  ##          ####      ##  ##
##    ##  ######    ####  ##  ##
####    ####      ##      ##  ##
######        ##      ####      
################################
