################################
    ####        ##            ##
##        ##  ##    ########  ##
##  ##  ##  ##    ##      ##  ##
##  ##          ##    ##  ##  ##
##  ########  ####  ##    ##  ##
##        ##        ##  ####  ##
##  ##  ##    ##  ####  ##    ##
##  ##    ####  ##      ##  ####
####  ##        ##  ##  ########
##    ##  ####  ##  ####    ####
##  ####    ##  ##      ##    ##
##      ##    ##  ####    ##  ##
##  ##  ##  ##      ##  ##    ##
##  ##          ##  ##      ##  
################################
