################################
    ##      ##                ##
##  ##  ##  ##  ########  ##  ##
##  ##  ##  ##  ##    ##    ####
##  ##  ##  ##  ##  ##  ##    ##
##      ##      ##  ##    ##  ##
####  ##  ########    ##      ##
##    ##  ##      ##  ##  ######
##  ##        ##      ##      ##
##  ##  ####    ####    ####  ##
##      ##  ####      ##      ##
##  ####        ##  ####  ##  ##
####      ####  ####      ##  ##
##    ####  ##        ####    ##
####        ##  ##  ##      ##  
################################
