################################
  ####            ##      ##  ##
####    ##  ####      ##      ##
##    ##  ##    ##  ####  ##  ##
####  ##      ####  ##    ##  ##
##        ######      ####    ##
##  ##  ##      ##  ##      ####
##  ####    ##  ####    ####  ##
##    ##  ####        ##      ##
####  ##      ##  ####  ##  ####
####    ####    ##          ####
##  ##    ####      ##  ####  ##
##    ##      ##  ##  ##      ##
##  ####  ##    ##      ####  ##
##          ##      ##          
################################
