################################
    ##        ##  ##  ####    ##
##      ######    ##        ####
####  ##        ##    ##  ######
####      ######  ##  ##    ####
##    ####        ##  ####    ##
##  ##      ##  ####    ####  ##
##    ####    ##      ##      ##
####  ######      ####    ##  ##
####    ####  ####      ##    ##
##  ##      ####    ####    ####
##  ######  ##    ####  ##    ##
##          ##  ##        ##  ##
##  ########    ##  ######    ##
##            ##            ##  
################################
