################################
    ##          ##      ##    ##
##      ##  ##      ##    ##  ##
##  ##  ##    ######  ##  ##  ##
##    ##  ##          ##      ##
##  ##      ##  ##  ##    ##  ##
##  ##  ##    ####    ####  ####
####    ####  ##    ##        ##
##    ##  ##      ####  ####  ##
####  ##      ####      ####  ##
##    ##  ####      ####      ##
##  ##      ##  ####      ######
##  ##  ####        ##  ##    ##
##    ####    ####    ##    ####
####        ########      ####  
################################
