################################
  ##      ##  ##        ##    ##
##    ##        ##  ##      ####
##  ######  ##  ##  ####  ######
##    ##    ##  ####      ######
##  ##    ####        ##    ####
##  ##  ##      ##########    ##
####    ##  ####      ##  ##  ##
##    ##    ##    ##        ####
##  ##########  ##  ######  ####
##    ##                ##    ##
##  ####  ##  ########    ##  ##
##        ##  ##      ##  ##  ##
##  ######  ##    ##    ##    ##
##          ##  ######      ##  
################################
