################################
      ##    ##                ##
####      ##    ##########  ####
######  ##  ##  ##      ##    ##
######  ##      ##  ##      ####
####    ##  ######    ######  ##
##    ##    ##    ##  ##  ##  ##
##  ##  ##    ##  ##      ##  ##
##      ####  ##    ######    ##
##  ####      ####          ####
##  ##    ####      ##  ##    ##
##  ##  ######  ####  ######  ##
##  ##    ##    ##      ##    ##
##  ##  ##    ####  ##      ####
##          ##        ##  ####  
################################
