################################
    ##        ##      ##########
##      ##  ##    ##    ########
##  ####        ##  ##    ######
####  ##  ######      ##    ####
##        ##  ##  ##    ##    ##
##  ####  ##      ##  ######  ##
##    ##    ##  ##    ####    ##
####    ##    ##  ##        ####
##    ######  ##  ##########  ##
####    ##  ####              ##
##    ##        ####  ##  ##  ##
####      ####      ######    ##
##    ##    ######    ##    ####
##  ######        ##      ####  
################################
