################################
            ##          ##    ##
####  ##  ##    ##  ##  ####  ##
##    ####    ##    ##        ##
####      ##    ##  ##  ####  ##
##    ##    ##  ##    ##      ##
####    ##    ##    ##    ##  ##
##    ##  ##    ##    ####    ##
####        ########      ##  ##
##  ######      ##    ##  ##  ##
##  ##    ####    ####      ####
##      ##  ####      ####    ##
####  ##      ######      ##  ##
##    ##  ##      ####  ##    ##
####        ####            ##  
################################
